cancel	huỷ bỏ
nicely	thú vị, dễ chịu
prepare	chuẩn bị
half	một nửa
fifty	năm mươi
surgeon	bác sĩ phẫu thuật
disapproval	sự phản đổi, sự không tán thành
discourage	gây chán nản cho
hall	đại sảnh
oversee	giám sát
pollution	sự ô nhiễm
salary	lương
pretend	giả vờ
tea	trà
drunk	say
would	sẽ
pick	chọn
rabbit	Con thỏ
customs	thuế nhập khẩu, hải quan
ten	mười
sake	lợi ích
energy	năng lượng
successfully	thành công
solid	chất rắn
meanwhile	trong khi đó
narrative	tường thuật
investment	đầu tư
require	yêu cầu
scratch	vết trầy
click	nhấp chuột
cooperative	hợp tác xã
size	kích thước
left	trái
rounded	bị làm thành tròn; phát triển đầy đủ
eleven	mười một
protective	bảo vệ
amusing	vui thích
sideways	ngang, từ một bên; sang bên
statute	đạo luật
object	vật
newspaper	báo chí
accessible	có thể truy cập
hang	treo
statistical	thống kê
role	vai trò
cliff	vách đá
roll	cuộn
I	tôi
concede	công nhận
turn	xoay
blond	tóc vàng
balanced	cân bằng
elect	trúng tuyển
example	thí dụ
gold	vàng
result	kết quả
opposition	Sự đối lập
golf	golf
same	tương tự
commission	Uỷ ban
after	sau
quiet	Yên tĩnh
flip	lật
connect	kết nối
rational	hợp lý
hand	tay
policy	chính sách
rebuild	xây dựng lại
resume	tiếp tục
a	một
address	địa chỉ nhà
salt	Muối
artistic	nghệ thuật
eating	Ăn
blood	máu
neighbor	hàng xóm
straight	thẳng
the	các
sale	buôn bán
police	cảnh sát
outdoors	ở ngoài trời, ở ngoài nhà
throw	ném
exciting	thú vị
fifth	thứ năm
obvious	hiển nhiên
thank	cảm tạ
information	thông tin
regain	giành lại
surgery	phẫu thuật
november	tháng 11
violent	hung bạo
resolve	giải quyết
confront	đối đầu
good	tốt
deploy	triển khai
empty	trống
faithful	trung thành, chung thủy, trung thực
reproduce	tái sản xuất
tie	cà vạt
scholarship	học bổng
besides	ngoài ra
tin	thiếc
serious	nghiêm trọng
implement	thực hiện
tip	tiền boa
export	xuất khẩu
laugh	cười
others	Khác
well-being	hạnh phúc
fantasy	tưởng tượng
unhappiness	nỗi buồn, sự bất hạnh
check	kiểm tra
onto	trên
sand	cát
frustrate	thất vọng
aside	qua một bên
grandparent	ông bà
supposed	giả định
Afghanistan	Cộng hòa Áp-gha-nít-tan
harm	làm hại
downwards	xuống, đi xuống
inmate	tù nhân
provided	cung cấp
rope	dây thừng
lens	ống kính
representation	đại diện
society	xã hội
nowhere	hư không
motive	động cơ
provider	các nhà cung cấp
romantic	lãng mạn
behavioral	hành vi
motivate	động viên
root	nguồn gốc
hard	cứng
projection	chiếu
multiply	nhân lên, làm tăng lên nhiều lần; sinh sôi nảy nở
spoil	cướp, cướp đọat
tonne	tấn
lend	cho vay
effectiveness	hiệu quả
roof	mái nhà
pilot	Phi công
ticket	vé
cheek	má
umbrella	ô, dù
approval	sự chấp thuận
multiple	nhiều
concentrate	tập trung
expose	lộ ra
cheer	vui lên
room	phòng
versus	đấu với
better	tốt hơn
explosion	nổ
apart from	ngoài… ra
permit	cho phép
translation	dịch
well	tốt
cancer	ung thư
personnel	Nhân sự
suitable	thích hợp
romance	lãng mạn
camping	sự cắm trại
allegation	cáo buộc
catalog	mục lục
pile	Đóng cọc
pioneer	người tiên phong
pill	Viên thuốc
myth	huyền thoại
experiment	thí nghiệm
flour	bột mì
implication	hàm ý
fierce	khốc liệt
reservation	đặt phòng
block	khối
hate	ghét bỏ
flow	lưu lượng
cooperation	hợp tác
order	gọi món
therapist	nhà trị liệu
movie theater	rạp chiếu phim
distant	xa xôi
litre	lít
custody	quyền nuôi con
propose	cầu hôn
reform	cải cách
unusual, unusually usual	hiếm, khác thường
crazy	khùng
coach	huấn luyện viên
hash	băm
southeast	Đông Nam
pink	hồng
woman	đàn bà
pine	cây thông
fuck	quan hệ tình dục
save	tiết kiệm
protection	sự bảo vệ
respectively	tương ứng
pint	panh
toe	ngón chân
irony	mỉa mai
matter	vấn đề
bandage	dải băng; băng bó
frankly	thẳng thắn
ton	tấn
top	hàng đầu
syndrome	hội chứng
too	quá
surname	họ
have	có
noise	tiếng ồn
shorts	quần short
toy	đồ chơi
haul	lôi
product	sản phẩm
famous	nổi danh
question	câu hỏi
reminder	nhắc nhở
lover	người yêu
spirit	tinh thần
intellectual	trí tuệ
cheap	giá rẻ
noisy	ồn ào, huyên náo
produce	sản xuất
picture	hình ảnh
cheat	lừa đảo
regard	quan tâm
constraint	hạn chế
rose	bông hồng
unreasonable	vô lý
thousand	nghìn
infect	nhiễm, tiêm nhiễm, đầu độc, lan truyền
capital	thủ đô
minor	diễn viên phụ
traveler	du khách
cop	cảnh sát
fuel	nhiên liệu
hostile	Hostile
cow	bò
employee	Nhân viên
lab	phòng thí nghiệm
upon	trên
pray	cầu nguyện
crawl	thu thập thông tin
identical	giống nhau
plead	biện hộ
ambitious	đầy tham vọng
towel	khăn tắm
academic	học tập
function	chức năng
raise	nâng cao
spoon	cái thìa
west	hướng Tây
employer	nhà tuyển dụng
quite	khá
lap	vòng
pipe	ống
pitcher	người bình
representative	Tiêu biểu
tower	Tháp
traffic	giao thông
well-known	nổi tiếng
actress	nữ diễn viên
comparison	so sánh
including	kể cả
law	pháp luật
lay	đặt nằm
plenty	nhiều
less	ít hơn
adventure	cuộc phiêu lưu
condition	điều kiện
thirsty	khát, cảm thấy khát
ceremony	Lễ
improve	cải tiến
obligation	nghĩa vụ
violation	sự vi phạm
bombing	ném bom
try	thử
chicken	gà
university	trường đại học
technique	kỹ thuật
artificially	nhân tạo
effective	có hiệu lực
wound	vết thương
teacher	giáo viên
similarly	tương tự
swimming pool	bể nước
muscle	cơ bắp
generous	hào phóng
jelly	thạch
floor	sàn nhà
possibility	khả năng
direction	phương hướng
exhibition	triển lãm
wounded	bị thương
ideological	ý thức hệ
alcoholic	rượu; người nghiện rượu
cry	khóc
inspector	thanh tra
opening	khai mạc
doctor	Bác sĩ
industrial	công nghiệp
investor	nhà đầu tư
stable	ổn định
pillow	cái gối
spoken	nói theo 1 cách nào đó
respond	trả lời
incident	biến cố
maintenance	bảo trì
sport	môn thể thao
cluster	cụm
unlikely likely	không có thể xảy ra, không chắc chắn; không có thực
goodbye exclamation,	tạm biệt; lời chào tạm biệt
expedition	thám hiểm
in general	nói chung, đại khái
concert	buổi hòa nhạc
pity	lòng thương hại, điều đáng tiếc, đáng thương
in favour/favor	ủng hộ cái gì
absorb	hấp thụ
supply	cung cấp
uncertain	không chắc chắn
concern	mối quan ngại
leg	Chân
unimportant	khônh quan trọng, không trọng đại
beautiful	đẹp
integrity	chính trực
mountain	núi
let	để cho
n't	không
adviser	cố vấn
state	tiểu bang
cargo	hàng hóa
dock	bến tàu
press	nhấn
worker	công nhân
dough	bột
element	thành phần
environmental	môi trường
good at	tiến bộ ở
night	đêm
pace	tốc độ
probable	có thể, có khả năng
opposite	đối diện
pack	đóng gói
each	mỗi
cue	gợi ý
offering	chào bán
enroll	ghi danh
stereotype	khuôn mẫu
groceries	hàng tạp hóa
cup	tách
thirty	ba mươi
polite	lễ phép, lịch sự
cut	cắt tỉa
perfectly	hoàn hảo
entertainment	sự giải trí
probably	có lẽ
warrior	chiến binh
document	tài liệu
jurisdiction	quyền hạn
constitutional	hiến pháp
killing	giết chết
availability	khả dụng
battery	ắc quy
two	hai
clay	đất sét
moment	chốc lát
promote	Quảng bá
tear	nước mắt
calmly	yên lặng, êm ả; bình tĩnh, điềm tĩnh
scenario	kịch bản
attack	tấn công
humour	sự hài hước, sự hóm hỉnh
builder	người xây dựng
divorce	ly hôn
attach	đính kèm
distribute	phân phát
worried	lo lắng
kitchen	phòng bếp
shout	kêu la
ankle	mắt cá
creation	sự sáng tạo
situation	tình hình
legislation	pháp luật
think	suy nghĩ
ingredient	thành phần
participate	tham dự
ex- prefix	tiền tố chỉ bên ngoài
anxiously	lo âu, lo lắng, băn khoăn
reporter	phóng viên
team	đội
withdrawal	thu hồi
shove	xô
timetable	kế hoạch làm việc, thời gian biểu
marketing	tiếp thị
prayer	cầu nguyện
speech	phát biểu
watch	đồng hồ đeo tay
clap	vỗ, vỗ tay; tiếng nổ, tiếng vỗ tay
purple	màu tím
quit	thoái lui
polish	nước bóng, nước láng; đánh bóng, làm cho láng
Jew	Người Do Thái
cabinet	buồng
thing	Điều
fashion	thời trang
insurance	bảo hiểm
southwest	tây nam
surely	chắc chắn
medical	Y khoa
principle	nguyên tắc
two-thirds	hai phần ba
thigh	đùi
lid	Nắp
importantly	quan trọng
as well	cũng, cũng như
lie	nói dối
source	nguồn
smell	mùi
participant	người tham gia
domestic	trong nước
initiate	bắt đầu
unable	không thể
lip	môi
dying	chết
uncontrolled	không bị điều khiển, không bị kiểm tra, không bị hạn
separation	tách biệt
bias	sự thiên vị
donation	Quyên góp
shoot	bắn
stability	sự ổn định
budget	ngân sách
actual	thực tế
chest	ngực
eastern	phương Đông
glass	ly
tension	căng thẳng
reflection	sự phản chiếu
campus	khuôn viên
juror	bồi thẩm đoàn
ultimate	tối hậu
widely	rộng rãi
doubt	nghi ngờ
jacket	Áo khoác
merit	n
verbal	lời nói
alphabetically	theo thứ tự abc
develop	phát triển, xây dựng
surprising	thật ngạc nhiên
harassment	quấy rối
suited	hợp, phù hợp, thích hợp với
involved	có tính liên quan
district	huyện
overall	tổng thể
fixed	đã sửa
page	trang
assume	giả định
full	đầy
pepper	tiêu
Italian	người Ý
away	xa
memory	ký ức
scientist	nhà khoa học
concept	khái niệm
motivation	động lực
house	nhà ở
disaster	thảm họa
stare	nhìn chằm chằm
painful	đau đớn
enhance	nâng cao
convention	quy ước
harvest	mùa gặt
opposing	tính đối kháng, đối chọi
pain	đau đớn
center	Trung tâm
suspicion	nghi ngờ
purchase	mua, tựa vào, bám vào
refusal	sự từ chối, sự khước từ
shore	bờ biển
start	khởi đầu
teen	thiếu niên
pair	đôi
lifestyle	lối sống
manage	quản lý
equal	công bằng
unpleasant pleasant	không dễ chịu, khó chịu
fund	quỹ
gravity	nghiêm trọng
recipient	người nhận
short	ngắn
FALSE	SAI
finance	tài chính
parking	bãi đỗ xe
studio	studio
downward	xuống, đi xuống
palm	lòng bàn tay
regulate	quy định
three	số ba
required	cần thiết
climb	leo
premise	tiền đề
whoever	bất cứ ai
golden	vàng
season	Mùa
controversial	gây tranh cãi
payment	thanh toán
specifically	đặc biệt
enter	đi vào
lonely	cô đơn
gallery	bộ sưu tập
pale	nhợt nhạt
hardware	phần cứng
plaintiff	nguyên đơn
deputy	Phó
warmth	ấm áp
destroy	hủy hoại
hostage	con tin
fffff	hihi
priority	sự ưu tiên
creative	sáng tạo
coast	bờ biển
judicial	tư pháp
shuttle	đưa đón
untidy tidy	không gọn gàng, không ngăn nắp, lộn xộn
provide	cung cấp
athletic	Khỏe mạnh
primary	sơ cấp
log	đăng nhập
enterprise	doanh nghiệp
reliability	độ tin cậy
bright	sáng
solar	hệ mặt trời
consume	tiêu dùng
teaching	giảng bài
formation	sự hình thành
accidental	tình cờ, bất ngờ
unknown	không xác định
glasses	kính đeo mắt
lot	nhiều
computer	máy vi tính
premium	phí bảo hiểm
low	thấp
assure	cam đoan
cellphone	điện thoại di động
consult	tham khảo ý kiến
merely	đơn thuần
planner	lập kế hoạch
on behalf of sb	thay mặt cho ai, nhân danh ai
wealth	sự giàu có
means	của cải, tài sản, phương tiện
funding	kinh phí
performer	người biểu diễn
survive	tồn tại
wallet	cái ví
doll	búp bê
initial	ban đầu
centre	điểm giữa, trung tâm, trung ương
fellow	đồng bào
fetch	tìm về, đem về; làm bực mình; làm say mê, quyến rũ
barely	vừa đủ
cling	bám lấy
diabetes	Bệnh tiểu đường
clip	kẹp
door	cửa
quick	nhanh chóng
nutrient	chất dinh dưỡng
alliance	liên minh
dad	cha
friendly	thân thiện
possession	chiếm hữu
tell	nói
husband	người chồng
experience	kinh nghiệm
dam	con đập
commander	chỉ huy
courtroom	phòng xử án
zone	vùng
affair	chuyện
day	ngày
combination	sự phối hợp
banana	trái chuối
jewelry	đồ trang sức
obtain	đạt được
drinking	uống
curiosity	sự tò mò
island	Đảo
format	định dạng
sacrifice	sự hy sinh
particular	cụ thể
theological	thần học
p.m.	quá trưa, chiều, tối
illegal	bất hợp pháp
water	Nước
pause	tạm ngừng
formal	chính thức
instructor	giảng viên
perceived	lĩnh hội
troop (PL)	quân (PL)
entertain	giải trí, tiếp đón, chiêu đãi
ease	giảm bớt
tent	lều
critical	chỉ trích
mathematics	toán học
part	phần
elsewhere	ở nơi khác
envision	hình dung
bike	xe đạp
principal	hiệu trưởng
tend	có xu hướng
east	Đông
shall modal	dự đoán tương lai: sẽ
exotic	kỳ lạ
relief	cứu trợ
wildly	dại, hoang
introduction	Giới thiệu
park	công viên
therapy	trị liệu
concentration	sự tập trung
heavily	nặng nề
colleague	đồng nghiệp
diamond	kim cương
economics	Kinh tế học
confession	lời thú tội
someone	người nào
third	thứ ba
build	xây dựng
entertainer	người quản trò, người tiếp đãi, chiêu đãi
earn	kiếm
interaction	sự tương tác
further	xa hơn nữa; thêm nữa
interfere	gây trở ngại
apartment	căn hộ, chung cư
tolerate	tha thứ
electronics	thiết bị điện tử
stack	cây rơm
Republican	Đảng Cộng hòa
parliament	nghi viện, quốc hội
path	con đường
crack	cừ, xuất sắc; làm nứt, làm vỡ, nứt nẻ, rạn nứt
bind	trói buộc
depending	tùy
record	ghi lại
blankly	ngây ra, không có thần
railway	đường sắt
prevention	Phòng ngừa
announcement	thông báo
crisp	giòn
carefully	cẩn thận
pass	vượt qua
mile	dặm
past	quá khứ
impact	va chạm
mild	nhẹ nhàng
profile	Hồ sơ
shock	sốc
switch  on	bật điện
milk	Sữa
bill	hóa đơn
CEO	CEO
Arab	Arab
easy	dễ dàng
whose	có
buyer	người mua
mill	cối xay
bucket	cái xô
senior	cao cấp
dose	liều
domain	miền
adult	người lớn
attitude	Thái độ
relative	quan hệ
average	Trung bình cộng
treatment	điều trị
compare	so sánh
influential	có ảnh hưởng
Bible	Kinh Thánh
transparent	trong suốt; dễ hiểu, sáng sủa
adoption	nhận con nuôi
grasp	sự hiểu biết
journal	tạp chí
distinctive	đặc biệt
composition	thành phần
grass	cỏ
unlike	không giống
annoyed	bị khó chịu, bực mình, bị quấy rầy
hotel	khách sạn
wednesday	thứ 4
term	kỳ hạn
acquisition	mua lại
deadline	hạn chót
so-called	cái gọi là
mine	tôi
grateful	tri ân
mind	lí trí
business	kinh doanh
retailer	nhà bán lẻ
Iraqi	Iraqi
staff	cán bộ
involve	liên quan
partly	từng phần
possible	khả thi
right	đúng
be going to	sắp sửa, có ý định
stage	sân khấu
complicated	phức tạp
borrow	vay
maximum	tối đa
inch	insơ
desert	Sa mạc
under	Dưới
quarter	phần tư
die	chết
dig	đào
added	thêm
emergency	trường hợp khẩn cấp
dip	nhúng
down	xuống
unacceptable acceptable	không thể chấp nhận
faculty	giảng viên
habit	thói quen
later	một lát sau
passport	hộ chiếu
bird	chim
clue	manh mối
club	câu lạc bộ
legal	hợp pháp
midst	giữa
bye exclamation	tạm biệt
lawmaker	nhà lập pháp
highway	Xa lộ
businessman	doanh nhân
signal	tín hiệu
possibly	có thể
journey	hành trình
test	thử nghiệm
finally	cuối cùng
enforcement	thực thi
exhaust	thoát ra
varied	thuộc nhiều loại khác nhau, những vẻ đa dạng
conviction	lòng tin chắc, sự kết án, phán quyết
grape	giống nho
brown	nâu
publicly	công khai
straw	Rơm rạ
regarding	về
sodium	natri
acceptance	chấp thuận
month	tháng
petrol	xăng dầu
final	sau cùng
tackle	giải quyết
distract	làm mất tập trung
occasion	dịp
loan	tiền vay
squeeze	bóp
virtual	ảo
rather	hơn
importance	tầm quan trọng
back	trở lại
endless	bất tận
training	đào tạo
expectation	sự mong đợi
title	chức vụ
miss	bỏ lỡ
pound	pao
load	tải trọng
bite	cắn
disgusting	làm ghê tởm, kinh tởm
ignore	bỏ qua
company	Công ty
nuclear	Nguyên tử
human	Nhân loại
poetry	thơ phú
prince	hoành tử
yeah exclamation	vâng, ừ
spelling	sự viết chính tả
relax	thư giãn
custom	tập quán
length	chiều dài
priest	thầy tu
permission	sự cho phép
grand	lớn
schedule	kế hoạch
beach	bờ biển
inherit	thừa kế
interpret	thông dịch
overwhelming	áp đảo
universe	vũ trụ
baby	đứa bé
blanket	cái mền
HÀ ANH HÙNG	BG 22/2/1999
grant	ban cho
qualified	đủ tư cách, điều kiện, khả năng
lunch	Bữa trưa
discount	giảm giá
construct	xây dựng
convert	đổi
attempt	cố gắng
Muslim	Hồi giáo
thick	dày
division	phân chia
balance	cân đối
supplier	nhà cung cấp
lock	Khóa
stand up	đứng đậy
used to modal	đã quen dùng
pitch	sân cỏ
text	bản văn
usually	thông thường
whereas	trong khi
proudly	một cách tự hào, một cách hãnh diện
kindness	sự tử tế, lòng tốt
fear	nỗi sợ
inspection	kiểm tra
cookie	bánh quy
printer	máy in, thợ in
appreciation	sự đánh giá
electrical	điện
statue	bức tượng
sense	giác quan
being	đang
physically	thể chất
field	cánh đồng
wilderness	hoang dã
baseball	bóng chày
interval	khoảng thời gian
legitimate	hợp pháp
dog	chó
evaluate	đánh giá
status	trạng thái
each other	nhau, lẫn nhau
trading	thương mại
upset	buồn bã
curve	đường cong
thief	kẻ trộm, kẻ cắp
embarrassed	xấu hổ
dot	dấu chấm
skin	da
stamp	tem; dán tem
skip	bỏ qua
mention	đề cập đến
mad	điên
government	chính quyền
known	nổi tiếng
legally	hợp pháp
legislator	nhà lập pháp
stream	suối
laundry	giặt ủi
nurse	y tá
coalition	liên minh
crime	tội ác
man	Đàn ông
stand	đứng
unnecessary necessary	không cần thiết, không mong muốn
map	bản đồ
surround	vây quanh
twenty	hai mươi
cigarette	thuốc lá
may	Tháng Năm
forward	phía trước
Roman	Roman
bless	ban phước
ethical	đạo đức
linhhh	aloaaaaa
comparable	so sánh
self-esteem	lòng tự trọng
opera	opera
mail	thư
presumably	có lẽ
bonus	thưởng
subject	môn học
use	sử dụng
recognition	sự công nhận
casino	casino
feel	cảm thấy
main	chủ yếu
sadness	sự buồn rầu, sự buồn bã
teenage	thiếu niên
terribly	khủng khiếp
aisle	lối đi
arrangement	sắp xếp
revenue	thu nhập
strip	dải
continuous	liên tiếp
negotiation	đàm phán
grain	ngũ cốc
credit	tín dụng
residence	nơi cư trú
oxygen	ôxy
terrible	khủng khiếp
alter	thay đổi
combine	phối hợp
waste	chất thải
cheerfully	vui vẻ, phấn khởi
textbook	sách giáo khoa
ideal	lý tưởng
comedy	phim hài
equipment	Trang thiết bị
dry	khô
establishment	thành lập
pressure	sức ép
streak	streak
feed	nuôi
background	lý lịch
unkind kind	không tử tế, không tốt
nonetheless	dù sao
colorful	Đầy màu sắc
handsome	đẹp
constitution	hiến pháp
stair	cầu thang
Canadian	người Canada
cocaine	cocaine
blend	trộn
conceive	thụ thai
disapproving	phản đối
nonsense	lời nói vô lý, vô nghĩa
breath	hơi thở
ball	trái bóng
meo	meoaa
repeat	nói lại
smoking	sự hút thuốc
seem linking	chọn lựa, chọn lọc
physical	vật lý
make	chế tạo
opposed	phản đối
thread	chủ đề
exactly	chính xác
rapidly	nhanh chóng
structure	kết cấu
intensity	cường độ
orange	trái cam
outdoor	ngoài trời
stake	cổ phần
witness	nhân
due	đến hạn
bake	bake
biscuit	bánh quy
threat	mối đe dọa
breast	nhũ hoa
invention	sự phát minh
please exclamation,	làm vui lòng, vừa lòng, mong... vui lòng, xin mời
curl	quăn, xoắn, uốn quăn, làm xoắn; sự uốn quăn
inform	thông báo
psychological	tâm lý
depend	tùy theo
sized	đã được định cỡ
about	trong khoảng
commit	cam kết
untidy	không gọn gàng, không ngăn nắp, lộn xộn
cure	chữa khỏi
curb	kiềm chế, nén lại, hạn chế
danger	nguy hiểm
take place	xảy ra, được cử hành, được tổ chức
crash	tai nạn
patch	vá
observer	người quan sát
presidency	chức tổng thống
bank	ngân hàng
character	tính cách
meaning	Ý nghĩa
above	ở trên
drawing	vẽ
cholesterol	cholesterol
magnetic	từ tính
stick	gậy
unlucky lucky	không gặp may, không may mắn
band	ban nhạc
orbit	quỹ đạo
comprise	bao gồm
height	Chiều cao
moderate	vừa phải
resident	cư dân
august	tháng tám
receiver	người nhận
singing	sự hát, tiếng hát
mall	trung tâm mua sắm
myself	riêng tôi
invent	phát minh
outer	bên ngoài
frozen	đông lạnh
wonderful	Tuyệt vời
allied	lien minh, đồng minh, thông
execute	thi hành
substantial	đáng kể
benefit	lợi ích
flood	lũ
booth	gian hàng
labor	lao động
quality	phẩm chất
unique	độc nhất
animal	thú vật
consistently	nhất quán
impatiently	nóng lòng, sốt ruột
boost	tăng
sincere	thật thà, thẳng thắng, chân thành
male	Nam giới
ministry	Bộ
shared	chia sẻ
shelter	nơi trú ẩn
examine	xem xét
old-fashioned	Cổ hủ
scan	quét
association	hiệp hội
eliminate	loại bỏ
industry	ngành công nghiệp
believe	tin
cute	dễ thương
mm-hmm	mm-hmm
long	Dài
remember	nhớ lại
into	vào
butterfly	Con bướm
glance	nháy mắt
frightening	kinh khủng, khủng khiếp
relationship	mối quan hệ
mix	pha trộn
destruction	sự phá hủy
dirty	dơ bẩn
striped	có sọc, có vằn
stiff	cứng
bother	làm phiền
expression	biểu hiện
middle	ở giữa
childhood	thời thơ ấu
star	ngôi sao
though	Tuy nhiên
wolf	chó sói
appeal	kháng cáo
many	nhiều
entrepreneur	doanh nhân
everyday	mỗi ngày
stay	ở lại
transportation	vận chuyển
controlled	được điều khiển, được kiểm tra
dedicate	dâng hiến
appear	xuất hiện
diary	Nhật ký
extensive	sâu rộng
residential	nhà ở
definitely	chắc chắn
collaboration	hợp tác
inspire	truyền cảm hứng
associated	liên kết
increasing	tăng
progress	tiến độ
Australia	nước Úc
open	mở
devote	cống hiến
seller	người bán
agent	đặc vụ
treat	đãi
wool	len
abortion	sự phá thai
bishop	giám mục
suffering	đau khổ
approximate	giống với, giống hệt với
invest	đầu tư
rapid	nhanh
project	dự án
seven	bảy
arena	đấu trường
barn	chuồng trại
loop	vòng lặp
post office	bưu điện
roughly	gần
tobacco	thuốc lá
wood	gỗ
emotionally	tình cảm
bare	trần
sidewalk	đường đi bộ
surprise	sự ngạc nhiên
suitcase	va li
beard	râu
look	nhìn
dense	dày đặc
cooker	lò, bếp, nồi nấu
flying	bay
regulator	người điều tiết
internet	liên mạng
allow	cho phép
knock	đánh
lord	chúa, vua
mass	khối lượng
proper	phù hợp
recording	ghi âm
beast	quái thú
poisonous	độc, có chất độc, gây chết, bệnh
vegetable	rau
bitter	đắng
speed	tốc độ
auction	bán đấu giá
gesture	cử chỉ
apple	táo
admit	thừa nhận
common	chung
interest	quan tâm
themselves	bản thân họ
bath	bồn tắm
organic	hữu cơ
twin	đôi
mask	mặt nạ
patrol	tuần tra
patron	người bảo trợ
winning	đang dành thắng lợi, thắng cuộc
apply	ứng dụng
recently	gần đây
overlook	bỏ qua
politician	chính trị gia
incredible	đáng kinh ngạc
separated	ly thân
bedroom	phòng ngủ
landing	đổ bộ
incredibly	vô cùng
money	tiền bạc
disagree	không đồng ý
healthy	khỏe mạnh
formula	công thức
step	bậc thang
disgust	làm ghê tởm, làm kinh tởm, làm phẫn nộ
forever	mãi mãi
mark	dấu
base	căn cứ
stem	thân cây
achievement	thành tích
trend	khuynh hướng
mechanic	thợ cơ khí
mom	mẹ
whole	toàn thể
zzzzz	....
revolution	Cuộc cách mạng
relation	quan hệ
loss	mất mát
reliable	đáng tin cậy
incentive	khuyến khích
elevator	thang máy
humor	hài hước
relate	liên hệ
routinely	thường
lost	mất đi
premises	biệt thự
per cent	phần trăm
preliminary	sơ bộ
obstacle	trở ngại
still	vẫn
van	van
biology	sinh học
work	công việc
lose	thua
constitute	cấu tạo
cattle	gia súc
playoff	playoff
toward	đối với
among	trong số
convince	thuyết phục
mate	người bạn đời
irritating	làm phát cáu, chọc tức
missionary	nhà truyền giáo
math	môn Toán
word	từ
theory	lý thuyết
contractor	nhà thầu
love	yêu
extension	sự mở rộng
internal	bên trong
gender	giới tính
signature	Chữ ký
tongue	lưỡi
architect	kiến trúc sư
literary	văn chương
republican	nhà nước cộng hòa
forehead	trán
enjoy	thưởng thức
foundation	nền tảng
secret	bí mật
ourselves	chúng ta
punch	đấm
laboratory, lab	phòng thí nghiệm
slave	nô lệ
across	băng qua
naturally	một cách tự nhiên
flexibility	Mềm dẻo
mortgage	thế chấp
identity	danh tính
ear	tai
installation	cài đặt
writing	viết
federal	liên bang
indoors	ở trong nhà
eat	ăn
loud	to tiếng
middle-class	tầng lớp trung lưu
reward	phần thưởng
hockey	khúc côn cầu
include	bao gồm
alongside	bên cạnh
swallow	nuốt
disagreement	sự bất đồng, sự không đồng ý, sự khác nhau
giaalmost	hầu như, gần như
aged	già đi
Korean	Hàn Quốc
sting	châm, chích, đốt; ngòi, vòi ; sự châm, chích..
juice	Nước ép
gathering	thu thập
opinion	quan điểm
lots	rất nhiều
altogether	hoàn toàn
soldier	lính
sleeve	tay áo
stir	khuấy
upsetting	tính đánh đổ, làm đổ
defender	hậu vệ
insult	lăng mạ, xỉ nhục; lời lăng mạ, sự xỉ nhục
voice	tiếng nói
prepared	đã được chuẩn bị
craft	nghề thủ công
existence	sự tồn tại
threshold	ngưỡng
float	phao
basketball	bóng rổ
Democrat	Dân chủ
defendant	bị cáo
portfolio	danh mục đầu tư
alley	hẻm
hunter	thợ săn
on purpose	cố tình, cố ý, có chủ tâm
exaggerate	cường điệu, phóng đại
discover	khám phá
spell	Đánh vần
midday	trưa, buổi trưa
exploration	thăm dò
imply	ngụ ý
capture	nắm bắt
excite	kích thích, kích động
revision	sự xem lại, sự đọc lại, sự sửa lại, sự ôn lại
qualification	phẩm chất, năng lực; khả năng chuyên môn
sequence	trình tự
provision	điều khoản
recruit	tuyển dụng
mud	bùn
mum	mẹ
scientific	thuộc về khoa học
congratulations	sự chúc mừng, khen ngợi; lời chúc mừng, khen
chunk	mảnh
winter	mùa đông
elder	đàn anh
platform	nền tảng
walking	đi dạo
spend	tiêu
grave	phần mộ
advantage	lợi thế
assistant	phụ tá
instead	thay thế
controversy	tranh cãi
ultimately	cuối cùng
command	chỉ huy
dessert	món tráng miệng
anticipate	đoán trước
variable	biến
temple	ngôi đền
will modal	sẽ; ý chí, ý định
irritated	tức giận, cáu tiết
landscape	phong cảnh
exception	ngoại lệ
temporary	tạm thời
habitat	môi trường sống
egg	trứng
desperate	tuyệt vọng
sufficiently	đủ, thích đáng
year	năm
leading	dẫn đầu
awful	kinh khủng
politically	chính trị
yeah	yeah
ego	tự ngã
branch	chi nhánh
urge	thúc giục
via	thông qua
high-tech	công nghệ cao
music	Âm nhạc
absent	vắng mặt, nghỉ
empire	đế chế
neat	khéo léo
understanding	hiểu biết
visual	trực quan
because	bởi vì
near	ở gần
silence	khoảng lặng
educate	giáo dục
moving	động, hoạt động
agreement	thỏa thuận
instruct	dạy
mayor	thị trưởng
merchant	thương gia
economy	nên kinh tê
community	cộng đồng
packet	gói nhỏ
version	phiên bản
bronze	đồng
planning	lập kế hoạch
selection	lựa chọn
stop	dừng lại
guess	phỏng đoán
conception	quan niệm
science	khoa học
guest	khách
detail	chi tiết
appropriate	thích hợp
forest	rừng
for instance	ví dụ chẳng hạn
least	ít nhất
utility	tiện ích
immediately	ngay
quarterback	tiền vệ
measurement	phép đo
optimistic	lạc quan
sleep	ngủ
hungry	đói bụng
swimming	bơi lội
refuse	từ chối
particle	hạt
behavior	hành vi
musician	nhạc sĩ
secretly	bí mật, riêng tư
minimize	giảm thiểu
sweep	quét
descend	hạ xuống
unfriendly	không thân thiện, không có thiện cảm
density	tỉ trọng
flavour	vị, mùi; cho gia vị, làm tăng thêm mùi vị
learn	học hỏi
neck	cái cổ
logical	hợp lý
slam	sập
characterize	đặc trưng
weird	kỳ dị
ridiculous	nực cười
severe	nghiêm trọng
emerge	hiện ra
exploit	khai thác
sweet	ngọt
slap	tát
anniversary	ngày kỷ niệm
steeply	dốc, cheo leo
screening	kiểm tra
eager	hăng hái
evidence	chứng cớ
well known	nổi tiếng, được nhiều người biết đến
republic	nước cộng hòa
historical	lịch sử
official	chính thức
till until	cho đến khi, tới lúc mà
ethics	đạo đức
spring	mùa xuân
assessment	thẩm định, lượng định, đánh giá
autonomy	tự trị
should modal	nên
fitness	sự tập thể dục
leave	rời khỏi
excluding	ngoài ra, trừ ra
cottage	nhà tranh
discrimination	kỳ thị
female	giống cái
faint	mờ nhạt
minister	bộ trưởng, mục sư
cruel	hung ác
need	nhu cầu
shade	bóng râm
originally	ban đầu
instead of	thay cho
often	thường xuyên
gather	tụ họp
jail	nhà giam
insist	năn nỉ
kindly	tử tế, tốt bụng
volume	âm lượng
guideline	hướng dẫn
loose	lỏng lẻo
hardly	khó khăn
sailing	sự đi thuyền
useful	hữu ích
private	riêng tư
baggage	hành lý
technical	kỹ thuật
companion	đồng hành
ride	dap xe
finely	đẹp đẽ, tế nhị, cao thượng
desperately	tuyệt vọng
precisely	đúng
stretch	căng ra
accomplish	hoàn thành
engine	động cơ
irritate	làm phát cáu, chọc tức
responsible	chịu trách nhiệm
medal	huy chương
end	kết thúc
photographer	nhiếp ảnh gia
satellite	vệ tinh
bullet	đạn
forty	bốn mươi
mistake	sai lầm
rich	giàu có
rice	cơm
praise	ca ngợi
forum	diễn đàn
scissors	cái kéo
significance	tầm quan trọng
special	đặc biệt
horizon	đường chân trời
environment	môi trường
DNA	DNA
airplane	Máy bay
sweat	mồ hôi
Indian	người Ấn Độ
progressive	cấp tiến
pronounce	tuyên bố, thông báo, phát âm
family	gia đình
deliberate	thận trọng, có tính toán, chủ tâm, có suy nghĩ cân nhắc
fall asleep	ngủ thiếp đi
swear	xin thề
atmosphere	không khí
gift	quà tặng
decorate	trang trí
slightly	khinh bỉ
career	nghề nghiệp
education	giáo dục
occupation	nghề nghiệp
charter	điều lệ
release	giải phóng
toll	số điện thoại
moral	đạo đức
newly	mới
gradually	dần dần
rehabilitation	phục hồi chức năng
explode	đập tan , làm nổ, nổ
brave	can đảm
narrow	hẹp
judge	thẩm phán
darkness	bóng tối
manipulate	vận dụng
similar	giống
ecological	sinh thái
partnership	hợp tác
shape	hình dạng
practitioner	học viên
specify	chỉ định
forth	ra
driver	người lái xe
compose	soạn, biên soạn
seventh	thứ bảy
Olympics	Thế vận hội
singer	ca sĩ
tone	tấn
against	chống lại
skilfully	tài giỏi, khéo tay
explo de	nổ tung
cell	tế bào
holiday	ngày lễ
swell	sưng lên
manufacturer	nhà chế tạo
remind	nhắc lại
valid	có hiệu lực
encourage	khuyến khích
vacuum	Khoảng chân không
era	kỷ nguyên
potato	khoai tây
administer	quản lý
share	chia sẻ
deficit	thâm hụt
elegant	thanh lịch
shark	cá mập
thoroughly	triệt để
honestly	thành thật
grandmother	bà ngoại
television	tivi
chairman	Chủ tịch
sharp	nhọn
slip	trượt
species	loài
logic	logic
take sth off	cởi, bỏ cái gì, lấy đi cái gì
sanction (PL)	sự trừng phạt (PL)
shake	lắc
cent	đồng xu
honor	tôn vinh
spice	gia vị
screen	màn
naked	trần truồng
trial	thử nghiệm
perception	nhận thức
undertake	thực hiện
etc	vv
indigenous	bản địa
bureau	phòng làm việc
entrance	cổng vào
net	mạng lưới
cable	cáp
nasty	bẩn thỉu
intense	cường độ cao
new	Mới
alphabetical	thuộc bảng chứ cái
below	phía dưới
estate	bất động sản
articulate	khớp nối
shall	sẽ
spicy	có gia vị
tool	dụng cụ
driving	điều khiển
yell	hét lên
secular	thế tục
tribe	bộ lạc
supervisor	người giám sát
boundary	ranh giới
shame	xấu hổ
supportive	hỗ trợ
mandate	ủy nhiệm
unexpectedly	bất ngờ, gây ngạc nhiên
Mr	Ông
Ms	Cô
elderly	người lớn tuổi
financial	tài chính
keen on	say mê, ưa thích
media	phương tiện truyền thông
slot	khe
trick	lừa
around	xung quanh
running	đang chạy
define	định nghĩa
talented	có tài
dictate	điều khiển
OK	được
photocopy	bản sao chụp; sao chụp
render	render
frontier	biên giới
relieve	giải tỏa
drawer	ngăn kéo
employment	việc làm
requirement	yêu cầu
transport	vận chuyển
pencil	bút chì
specific	riêng
super	siêu
PC	PC
engage	thuê
publicyhouse	quán rượu, tiệm rượu
switch  off	ngắt điện
whisper	thì thầm
needle	cây kim
strategy	chiến lược
PM	PM
risky	rủi ro
long-term	dài hạn
territory	lãnh thổ
amendment	sửa đổi
full-time	toàn thời gian
ring	nhẫn
maintain	duy trì
shift	sự thay đổi
couch	đi văng
echo	echo
angrily	tức giận, giận dữ
expertise	chuyên môn
bargain	sự mặc cả, sự giao kèo mua bán
cheese	phô mai
professional	chuyên nghiệp
locally	có tính chất địa phương, cục bộ
accusation	tố cáo
differently	khác
shoulder	vai
dance	nhảy
fully	đầy đủ
so that	để, để cho, để mà
dining	ăn uống
remain	vẫn còn
expected	kỳ vọng
amaze	làm ngạc nhiên, làm sửng sốt
toss	quăng
eye	mắt
envelope	phong bì
himself	bản thân anh ấy
dictionary	từ điển
mystery	huyền bí
slow	chậm
immoral	trái đạo đức, luân lý; xấu xa
deposit	tiền gửi
flash	đèn flash
continent	lục địa
might modal	qk. may có thể, có lẽ
complexity	phức tạp
maybe	có lẽ
another	khác
automatically	tự động
guarantee	Bảo hành
enemy	kẻ thù
recommend	giới thiệu
gray	màu xám
amused	vui thích
helicopter	máy bay trực thăng
vendor	nhà cung cấp
advertisement	quảng cáo
disabled	tàn tật
attribute	thuộc tính
mechanism	cơ chế
cemetery	Nghĩa trang
genetic	di truyền
triumph	triumph
horror	kinh dị
poison	chất độc, thuốc độc; đánh thuốc độc, tẩm thuốc độc
silly	ngớ ngẩn
gram	đậu xanh
black	đen
knitted	được đan, được thêu
riot	bạo loạn
nest	tổ
supporter	người ủng hộ
tour	chuyến du lịch
persuade	truy vấn
consensus	sự đồng thuận
boring	nhàm chán
such	như là
classic	cổ điển
absolute	tuyệt đối
describe	miêu tả
grab	vồ lấy
suck	hút
technological	công nghệ
TV	TV
wealthy	giàu có
administration	quản trị
jazz	jazz
genuinely	thành thật, chân thật
developing	phát triển
remains	đồ thừa, cái còn lại
incorporate	kết hợp
boast	khoe khoan
operator	nhà điều hành
research	nghiên cứu
openly	cởi mở
white	trắng
furniture	đồ nội thất
counterpart	đối tác
segment	phần
stripe	sọc, vằn, viền
huge	khổng lồ
c rack	bẻ khóa
attractive	hấp dẫn
imagine	tưởng tượng
town	thị trấn
might	có thể
engineering	kỹ thuật
girl	con gái
mentally	tinh thần
decrease	giảm bớt
whatever	bất cứ điều gì
museum	viện bảo tàng
embarrassing	làm lúng túng, ngăn trở
aloud	lớn tiếng, to tiếng
clothing	quần áo
next	kế tiếp
blind	mù quáng
nod	gật đầu
color	màu
hidden	ẩn
import	nhập khẩu
occupy	chiếm
string	chuỗi
submit	đệ trình
nearly	Gần
blink	chớp mắt
summit	hội nghị thượng đỉnh
button	nút
conclusion	phần kết luận
nor	cũng không
not	không phải
central	Trung tâm
impose	áp đặt
now	hiện nay
statement	tuyên bố
and/or	và / hoặc
backyard	sân sau
factor	hệ số
faintly	nhút nhát, yếu ớt
in spite of	mặc dù, bất chấp
news	Tin tức
delivery	chuyển
rack	giá đỡ
election	cuộc bầu cử
green	màu xanh lá
race	cuộc đua
effectively	có hiệu quả
greet	chào hỏi
war	chiến tranh
sculpture	điêu khắc
way	đường
grey	xám, hoa râm
sensation	cảm giác
what	gì
urban	đô thị
detailed	chi tiết
furthermore	hơn nữa
refer	tham khảo
risk	rủi ro
attempted	cố gắng, thử
window	cửa sổ
flame	ngọn lửa
rise	tăng lên
container	thùng đựng hàng
play	chơi
subsidy	trợ cấp
criteria	tiêu chuẩn
quickly	Mau
decide	quyết định
nearby	gần đó
when	khi nào
modest	khiêm tốn
fan	quạt
crush	nghiền nát
hatred	lòng căm thì, sự căm ghét
far	xa
fat	mập
catch	bắt lấy
plan	kế hoạch
promising	hứa hẹn
metre	mét
give	đưa cho
counsel	lời khuyên
liver	Gan
double	gấp đôi
suicide	tự tử
comfortably	dễ chịu, thoải mái, tiện nghi, ấm cúng
explicit	rõ ràng
comfortable	Thoải mái
determined	đã được xác định, đã được xác định rõ
utilize	sử dụng
prevail	chiếm ưu thế
completely	hoàn toàn
suit	bộ đồ
chocolate	sô cô la
denial	từ chối
study	học
portion	phần
direct	thẳng thắn
fever	sốt
pick sth up	cuốc, vỡ, xé
gain	thu được
supermarket	siêu thị
confuse	nhầm lẫn
modern	hiện đại
web	web
occasionally	thỉnh thoảng
tragic	bi kịch
physician	bác sĩ
grin	nụ cười
grip	nắm chặt
explore	khám phá
wet	ướt
electricity	điện
climate	khí hậu
continuously	liên tục, liên tiếp
great	tuyệt quá
wrong	sai rồi
criticize	chỉ trích
shirt	áo sơ mi
further, furthest	cấp so sánh của far
organization	cơ quan
pleased	vừa lòng
rage	giận dữ
width	tính chất rộng, bề rộng
certain	chắc chắn
board	bảng
economic	thuộc kinh tế
statistics	số liệu thống kê
stuff	đồ đạc
indicator	chỉ thị
monkey	con khỉ
arrest	bắt giữ
distinction	phân biệt
widow	Người đàn bà góa
disability	khuyết tật
fee	chi phí
section	phần
used	đã sử dụng
constantly	liên tục
nut	hạt
retirement	nghỉ hưu
whip	roi da
rumor	tin đồn
protocol	giao thức
stressed	bị căng thẳng, bị ép, bị căng
whale	cá voi
provoke	kích động
threaten	hăm dọa
few	vài
rhetoric	Hùng biện
otherwise	nếu không thì
strain	sự căng thẳng, quá tải
licence	bằng, chứng chỉ, bằng cử nhân; sự cho phép
rain	mưa
hunt	săn bắn
visible	có thể nhìn thấy
rail	đường sắt
survival	Sự sống còn
plea	lời bào chữa
inner	bên trong
pleasing	mang lại niềm vui thích; dễ chịu
solely	chỉ
market	thị trường
keen	sắc, bén
personally	cá nhân
marker	đánh dấu
outside	ở ngoài
effect	hiệu ứng
keep	giữ
cruise	du lịch
elementary	tiểu học
producer	nhà sản xuất
topic	đề tài
perceive	nhận thức
sugar	đường
embarrass	lúng túng, làm ngượng nghịu; làm rắc rối, gây khó khăn
option	Tùy chọn
who	người nào
weigh	cân
politics	chính trị
game	trò chơi
unexpected	bất ngờ
crucial	quan trọng
contribute	Góp phần
faith	đức tin
why	tại sao
remark	nhận xét
chỉ huycomment	lời bình luận, lời chú giải; bình luận, phê bình, chú thích,
necessarily	nhất thiết
integrated	tích hợp
unemployment employment	sự thất nghiệp, tình trạng thất nghiệp
relaxed	thanh thản, thoải mái
alone	một mình
candidate	ứng viên
donor	nhà tài trợ
along	dọc theo
parallel	song song, tương đương
structural	cấu trúc
dialogue	đối thoại
peanut	đậu phụng
diet	chế độ ăn
unhappy happy	buồn rầu, khổ sở
win	thắng lợi
lawyer	luật sư
soccer	bóng đá
butter	bơ
handful	ít
electric	điện
stimulus	kích thích kinh tế
unfairly	gian lận, không công bằng; bất lợi
designer	nhà thiết kế
deal with	giải quyết
diminish	suy giảm
shine	tỏa sáng
administrative	hành chính
rely on	tin vào, tin cậy, tin tưởng vào
various	nhiều
attention	chú ý
shiny	sáng chói, bóng
headache	đau đầu
visit	chuyến thăm
reduction	giảm
user	người dùng
unfold	mở ra
extent	phạm vi
parent	cha mẹ
tie sth up	có quan hệ mật thiết, gắn chặt
bring	mang đến
sauce	Nước xốt
equity	công bằng
fit	Phù hợp
robot	robot
fix	sửa chữa
colonial	thuộc địa
honest	thật thà
manufacturing	chế tạo
assumption	giả thiết
giant	khổng lồ
pension	lương hưu
rank	cấp
outlet	đầu ra
grandchild	cháu ngoại
addition	thêm vào
ad	quảng cáo
carve	khắc chạm
gang	băng nhóm
grow	lớn lên
sure	chắc chắn rồi
excited	bị kích thích
shrink	co lại
ah	ah
ancestor	tổ tiên
league	liên đoàn
former	trước đây
panic	hoảng loạn
extend	mở rộng
fold	gập lại
as	như
at	tại
interpretation	diễn dịch
peace	hòa bình
folk	dân gian
competitive	cạnh tranh
consideration	xem xét
simultaneously	đồng thời
brother	em trai
hurt	đau
bb	d
be	được
prove	chứng minh
admire	ngưỡng mộ
consequently	hậu quả là
tomato	cà chua
virus	virus
rape	hãm hiếp
search	Tìm kiếm
metaphor	phép ẩn dụ
fool	ngu xuẩn
sudden	đột nhiên
by	bởi
popularity	phổ biến
genre	thể loại
whom	ai
cardboard	bìa cứng, các tông
panel	bảng điều khiển
foot	chân
tooth	răng
humanity	nhân loại
innovation	đổi mới
salty	chứ vị muối, có muối, mặn
charge	sạc điện
outstanding	nổi bật
familiar	quen
breathe	thở
flu	bệnh cúm
food	món ăn
survivor	người sống sót
actor	diễn viên
tropical	nhiệt đới
good (PL)	tốt (PL)
fly	bay
partner	cộng sự
plunge	lao xuống
voter	cử tri
freely	tự do
interview	phỏng vấn
essential	Cần thiết
good for	có lợi cho
scare	sợ hãi
unwilling, unwillingly willing	không muốn, không có ý định
language	ngôn ngữ
do	làm
observe	quan sát
meaningful	có ý nghĩa
rare	hiếm
warning	cảnh báo
exclude	loại trừ
make sth up	làm thành, cấu thành, gộp thành
scary	đáng sợ
creativity	sáng tạo
criticism	sự chỉ trích
heating	sự đốt nóng, sự làm nóng
commissioner	ủy viên
wow	wow
which	mà
image	hình ảnh
on board	trên tàu thủy
ribbon	ribbon
portray	miêu tả
confrontation	đối đầu
downstairs	ở dưới nhà, ở tầng dưới; xống gác; tầng dưới
profound	thâm thúy
marble	đá hoa
never	không bao giờ
celebration	lễ kỷ niệm
knife	dao
grow up	lớn lên, trưởng thành
piece	cái
oddly	kỳ quặc, kỳ cục, lẻ
burst	nổ
carry	mang
elephant	con voi
refrigerator	tủ lạnh
necessity	sự cần thiết
fog	sương mù
frame	khung
compelling	thuyết phục
origin	gốc
vocal	tiếng hát
for	cho
mistaken	sai lầm, hiểu lầm
content	Nội dung
burden	gánh nặng
random	ngẫu nhiên
perhaps	có lẽ
personality	nhân cách
plot	âm mưu
rate	tỷ lệ
skill	kỹ năng
oak	cây sồi
trouble	rắc rối
divide	chia
class	lớp học
contend	đấu tranh
reporting	Báo cáo
digital	kỹ thuật số
gamble	đánh bạc; cuộc đánh bạc
go	đi
counter	quầy tính tiền
rhythm	nhịp
fork	cái nĩa
form	hình thức
management	sự quản lý
publish	công bố
ha	ha
unlucky	không gặp may, bất hạnh
correspondent	phóng viên
gate	cánh cổng
he	anh ta
significantly	đáng kể
assign	chỉ định
promotion	quảng cáo
withdraw	thu hồi
feather	lông vũ
hi	Chào
very	rất
decade	thập kỷ
practice	thực hành
congress	đại hội, hội nghị, quốc hội
divine	thần thánh
welfare	phúc lợi
legislative	lập pháp
else	khác
four	bốn
contemplate	thưởng ngoạn
vessel	tàu
context	bối cảnh
easily	dễ dàng
drag	kéo
ie	nghĩa là
if	nếu
bathroom	phòng tắm
burnt	bị đốt, bị cháy, khê; rám nắng, sạm
chemist’s	hóa học, môn hóa học, ngành hóa học
violently	mãnh liệt, dữ dội
encouraging	khuyến khích
likely	có khả năng
issue	vấn đề
in	trong
literally	nghĩa đen
lower	thấp hơn
metal	kim loại
index	mục lục
ok  exclamation,	đồng ý, tán thành
doorway	lối vào
it	nó
fry	rán, chiên; thịt rán
announce	tuyên bố
odd	lẻ
somebody	có ai
conservation	bảo tồn
traditional	truyên thông
lively	sống, sinh động
contrast	tương phản
continuing	tiếp tục
annoying	chọc tức, làm bực mình; làm phiền, quẫy nhiễu
become	trở nên
eventually	cuối cùng
inflation	lạm phát
settlement	giải quyết
Israeli	Israeli
literature	văn chương
library	thư viện
sphere	quả cầu
ability	có khả năng
camera	Máy ảnh
at least	ít ra, ít nhất, chí ít
belief	niềm tin
delight	Hân hoan
sadly	một cách buồn bã, đáng buồn là, không may mà
immigration	nhập cư
suggestion	gợi ý
draw	vẽ tranh
off	tắt
generally	nói chung là
knee	đầu gối
first det	thứ nhất, đầu tiên, trước hết; người, vật đầu tiên, thứ nhất
wooden	bằng gỗ
oral	miệng
complete	hoàn thành
conscious	có ý thức
fun	vui vẻ
transaction	Giao dịch
accomplishment	hoàn thành
fur	lông thú
pants	quần lót, đùi
political	chính trị
while	trong khi
second	thứ hai
that	cái đó
edge	cạnh
faster	nhanh hơn
ruling	phán quyết
unconscious conscious	bất tỉnh, ngất đi
skirt	váy
sufficient	đủ
than	hơn
limit	giới hạn
me	tôi
claim	yêu cầu
credibility	uy tín
widespread	phổ biến rộng rãi
communication	giao tiếp
Palestinian	Palestine
chronic	mãn tính
fasten	buộc, trói
tolerance	lòng khoan dung
toxic	chất độc
contest	Cuộc thi
author	tác giả
meter	mét
dirt	bẩn
TRUE	THẬT
diagnosis	chẩn đoán
feeling	cảm giác
my	tôi
plus	thêm
expansion	sự bành trướng
coat	áo khoác
entry	nhập cảnh
license	giấy phép
disk	đĩa
expand	mở rộng
headquarters	trụ sở chính
dish	món ăn
dream	mơ tưởng
fiscal	tài chính
gaze	nhìn chằm chằm
essay	tiểu luận
prediction	dự đoán
coal	than
survey	khảo sát
devastating	tàn phá
disc	đĩa
plug	nút
bride	cô dâu
heat	nhiệt
no	Không
code	mã
legacy	di sản
hammer	búa
brightly	sáng chói, tươi
student	sinh viên
careful	cẩn thận
ideology	hệ tư tưởng
seal	niêm phong
mixed	pha trộn
investigate	điều tra
storage	lưu trữ
illusion	ảo giác
head	cái đầu
investigator	điều tra viên
considerable	đáng kể
oil	dầu
productivity	năng suất
of	của
heal	chữa lành
reserve	dự trữ
oh	Oh
somehow	bằng cách nào đó
brick	gạch
ok	được
sympathy	cảm thông
fight	chiến đấu
hear	Nghe
occupied	đang sử dụng, đầy
rescue	cứu hộ
on	trên
skilful	tài giỏi, khéo tay
brief	ngắn gọn
keyboard	bàn phím
pretty	đẹp
or	hoặc là
recover	bình phục
determine	mục đích
considerably	đáng kể
homeless	Vô gia cư
betting	sự đánh cuộc
cousin	anh chị em họ
teaspoon	muỗng cà phê
intelligent	thông minh
whilst	trong lúc, trong khi
equip	Trang bị
painting	bức vẽ
radiation	sự bức xạ
Christian	Christian
spiritual	tinh thần
unreasonable reasonable	vô lý, vượt quá giới hạn của cái hợp lý
increasingly	ngày càng
salad	rau xà lách
strategic	chiến lược
nation	quốc gia
readily	dễ dàng
rocket	tên lửa
convenience	tiện
determination	sự quyết tâm
discipline	kỷ luật
unload load	tháo, dỡ
fucking	fucking
emission	khí thải
extremely	vô cùng
freeze	Đông cứng
province	tỉnh
inevitably	chắc chắn
clever	lanh lợi, thông minh. tài giỏi, khéo léo
estimate	ước tính
brand	nhãn hiệu
put  out	tắt, dập tắt
recent	gần đây
they	họ
proposal	đề nghị
inevitable	chắc chắn xảy ra
consciousness	ý thức
edit	chỉnh sửa
old	cũ
frustration	thất vọng
them	họ
then	sau đó
ancient	xưa
seat	ghế
re	lại
cognitive	nhận thức
adopt	thông qua
attorney	luật sư
wander	đi lang thang
twelve	mười hai
oppose	phản đối
bridge	cầu
starting	bắt đầu
device	thiết bị
belly	bụng
conservative	thận trọng
conference	hội nghị
activity	Hoạt động
seed	giống
cabin	cabin
seek	tìm kiếm
seem	hình như
heel	gót chân
variety	đa dạng
disturb	xáo trộn
lecture	bài học
persist	tồn tại
pump	máy bơm
so	vì thế
unemployed	thất nghiệp; không dùng, không sử dụng được
accountability	trách nhiệm giải trình
email	thư điện tử; gửi thư điện tử
apart	xa nhau
teenager	thiếu niên
calendar	lịch
decision	phán quyết
necessary	cần thiết
starter	bắt đầu
one	một
garage	gara
closet	tủ quần áo
consist of	gồm có
speculate	suy đoán
ideally	lý tưởng, đúng như lý tưởng
closer	gần hơn
flower	hoa
monster	quái vật
single	Độc thân
pull	kéo
teammate	đồng đội
dealer	người buôn bán
assist	hỗ trợ
closed	đóng
to	đến
Dutch	Người Hà Lan
partially	một phần
undergraduate	đại học
makeup	trang điểm
country	Quốc gia
commercial	thương mại
joint	chung
aide	trợ lý
remarkably	đáng chú ý, đáng để ý; khác thường
separate	tách rời
reasonable	hợp lý
willing	sẵn lòng
ruler	người cai trị, người trị vì; thước kẻ
thank you	cảm ơn bạn
amazing	kinh ngạc
regularly	thường xuyên
Supreme	Tối cao
uh	uh
awareness	nhận thức
chairman, chairwoman	chủ tịch, chủ tọa
military	quân đội
reluctant	lưỡng lự
up	lên
us	chúng tôi
ensure	đảm bảo
organism	cơ thể
usual	thường lệ
epidemic	bệnh dịch
this	điều này
reasonably	hợp lý
suppose	giả sử
thin	gầy
flavor	hương vị
remarkable	đáng chú ý
brake	phanh
opt	opt
failure	thất bại
solve	giải quyết
know	biết
knot	cái nơ; điểm nút, điểm trung tâm
Internet	Internet
region	khu vực
frightened	hoảng sợ, khiếp sợ
support	ủng hộ
vs	vs
coin	đồng tiền
drop	rơi vãi
euro	đơn vị tiền tệ của liên minh châu âu
questionnaire	bảng câu hỏi
shaped	có hình dáng được chỉ rõ
destination	nơi đến
privacy	riêng tư
cold	lạnh
learning	học tập
vertical	theo chiều dọc
pure	nguyên chất
approving	tán thành, đồng ý, chấp thuận
damp	ẩm, ẩm ướt, ẩm thấp
life	đời sống
we	chúng tôi
willingly	sẵn lòng, tự nguyện
honey	mật ong
similarity	sự giống nhau
examination	kiểm tra
gap	lỗ hổng
screw	Đinh ốc
gas	khí đốt
emphasize	nhấn mạnh
set fire to	đốt cháy cái gì
gay	gay
slight	nhẹ
previous	Trước
wide	rộng
regime	chế độ
teach	dạy
reading	đọc hiểu
argue	tranh luận
damn	chỉ trích
superior	cấp trên
succeed	thành công
compensation	đền bù
location	vị trí
kilometre	kilômet
ecosystem	hệ sinh thái
software	phần mềm
seminar	hội thảo
competition	cuộc thi
none	không ai
type	kiểu
april	tháng tư
beyond	vượt ra ngoài
hell	Địa ngục
pupil	học sinh
practise	thực hành, tập luyện
problem	vấn đề
hazard	nguy hiểm
terms	điều kiện
unemployed employ	không dùng, thất nghiệp
depressed	suy sụp
voluntary	tình nguyện
connection	kết nối
deeply	sâu sắc
asleep	ngủ
proof	bằng chứng
abandoned	bị bỏ rơi, bị ruồng bỏ
presence	sự hiện diện
phase	giai đoạn
surrounding	xung quanh
inability	sự bất lực, bất tài
swearing	lời thề, lời nguyền rủa, lời thề hứa
researcher	nghiên cứu viên
may modal	có thể, có lẽ
method	phương pháp
wife	người vợ
contract	hợp đồng
conclude	kết luận
come	đến
leather	da
push	đẩy
exist	hiện hữu
innovative	sáng tạo
insight	cái nhìn sâu sắc
freshly	tươi mát, khỏe khoắn
fabric	vải
revolutionary	cách mạng
exact	chính xác
unemployment	thất nghiệp
indoor	trong nhà
lift	thang máy
nationwide	toàn quốc
force	lực lượng
sexual	tình dục
south	miền Nam
north	Bắc
German	tiếng Đức
distribution	phân phối
nervously	bồn chồn, lo lắng
our	của chúng ta
tyre	lốp, vỏ xe
Mrs	Bà
capacity	sức chứa
cope	đối phó
out	ngoài
confess	xưng
ghost	ma
noon	trưa
get	được
dark	tối
course	khóa học
sewing	sự khâu, sự may vá
in addition	thêm vào
copy	sao chép
power	quyền lực
precise	tóm lược
dare	dám
sensible	có óc xét đoán; hiểu, nhận biết được
pleasantly	vui vẻ, dễ thương; thân mật
precious	quí
cook	nấu ăn
cool	mát mẻ
sell	bán
continued	tiếp tục
pickup	nhặt lên
suspect	nghi ngờ
brain	óc
transformation	chuyển đổi
apologize	xin lỗi
amazed	kinh ngạc, sửng sốt
help	Cứu giúp
depth	chiều sâu
massive	to lớn
located	định vị
self	tự
asset	tài sản
owe	nợ
insulting	lăng mạ, xỉ nhục
minimum	tối thiểu
date	ngày
magic	ma thuật
dress	trang phục
reveal	tiết lộ
data	dữ liệu
theoretical	lý thuyết
corn	Ngô
onion	củ hành
own	sở hữu
sound	âm thanh
drum	trống
sales	bán hàng
translate	dịch
drug	thuốc uống
means (PL)	nghĩa là (PL)
norm	định mức
barrier	rào chắn
realistic	thực tế
create	tạo nên
criminal	phạm tội
blow	thổi
sunny	nắng
climbing	sự leo trèo
activist	nhà hoạt động
development	phát triển
curious	Hiếu kỳ
proud	tự hào
bitterly	đắng, đắng cay, chua xót
like	như
resource	tài nguyên
earthquake	động đất
nightmare	ác mộng
cord	dây
core	cốt lõi
ending	sự kết thúc, sự chấm dứt; phần cuối, kết cục
Senate	Thượng nghị viện
proposed	đề xuất
council	hội đồng
fraud	gian lận
ground	đất
visitor	khách thăm quan
send	gửi
concrete	bê tông
here	đây
note	chú thích
everybody	mọi người
shrimp	con tôm
purpose	mục đích
regret	hối tiếc
linh	aa
line	hàng
penalty	hình phạt
link	liên kết
snake	con rắn
scale	tỉ lệ
hero	anh hùng
riding	môn thể thao cưỡi ngựa, sự đi xe
recovery	phục hồi
hers	của cô ấy
security	Bảo vệ
contributor	người đóng góp
buck	buck
organize	tổ chức
station	ga tàu
disappointing	làm chán ngán, làm thất vọng
herb	thảo mộc
limb	chân tay
nose	mũi
factory	nhà máy
cost	Giá cả
will	sẽ
confidence	sự tự tin
confidently	tự tin
fishing	đánh bắt cá
implementation	thực hiện
smoke	hút thuốc lá
follow	theo
intent	ý định
African	Châu Phi
contrasting	tương phản
o’clock	đúng giờ
washing	sự tắm rửa, sự giặt
tuesday	thứ 3
compliance	sự tuân thủ
treaty	Hiệp ước
swollen	sưng phồng, phình căng
challenge	thử thách
dignity	phẩm giá
unimportant important	không quan trọng
harmless	không có hại
intend	dự định
wild	hoang dã
snap	chụp nhanh
associated with	liên kết với
must modal	phải, cần, nên làm
govern	quản lý
numerous	nhiều
analyse	phân tích
resemble	giống
your	của bạn
explanation	giải trình
remote	xa
rider	người lái
without	không có
youth	thiếu niên
these	những
graduation	tốt nghiệp
sovereignty	chủ quyền
calculate	tính toán
authorize	cho phép
prison	nhà tù
such as	đến nỗi, đến mức
sister	em gái
organizational	tổ chức
trauma	chấn thương
audience	thính giả
thus	do đó
sexually	tình dục
possess	sở hữu
coup	cuộc đảo chính
neutral	Trung tính
analysis	phân tích
fashionable	đúng mốt, hợp thời trang
hoanloose	lỏng, không chặt
lion	sư tử
apparent	rõ ràng
journalism	báo chí
journalist	nhà báo
correlation	tương quan
exposure	Phơi bày
historically	lịch sử
dawn	bình minh
wing	canh
much	nhiều
wine	rượu nho
wind	gió
chapter	chương
commodity	hàng hóa
flight	chuyến bay
independent	độc lập
defence	cái để bảo vệ, vật để chống đỡ, sự che chở
achieve	Hoàn thành
ahead	phía trước
anybody	bất kỳ ai
milligram	mi-li-gam
unable able	không thể, không có khẳ năng
yellow	màu vàng
according to	theo, y theo
alleged	cáo buộc
unsteady	không chắc, không ổn định
weekly	hàng tuần
economically	kinh tế
heve	áchheve
headline	tiêu đề
committee	ủy ban
union	liên hiệp
ruined	bị hỏng, bị đổ nát, bị phá sản
printing	sự in, thuật in, kỹ sảo in
wipe	lau
freshman	sinh viên năm nhất
subtle	tế nhị
component	thành phần
photograph	ảnh chụp
overwhelm	quá tải
suite	suite
blue	màu xanh da trời
consultant	tư vấn
unprecedented	chưa từng có
combined	kết hợp
god	thần, chúa
wrap	bọc
yours	của bạn
novel	cuốn tiểu thuyết
discuss	bàn luận
liberal	tự do
standard	Tiêu chuẩn
acceptable	chấp nhận được
harmony	hòa hợp
correct	chính xác
reader	người đọc
sharply	mạnh
chill	làm lạnh
swollen swell	phồng lên, sưng lên
Jewish	Người Do thái
dominate	thống trị
deadly	chết người
wish	muốn
institution	tổ chức
pad	tập giấy
wise	khôn ngoan
ambition	tham vọng
exceed	quá
pan	chảo
conversation	cuộc hội thoại
area	khu vực
fall over	ngã lộn nhào, bị đổ
murder	giết người
unsuccessful successful	không thành công, không thành đạt
pat	vỗ vỗ
invitation	lời mời
pay	trả
enormous	to lớn
European	Châu Âu
list	danh sách
strange	kỳ lạ
lack	thiếu sót
external	bên ngoài
wire	dây điện
spending	chi tiêu
circumstance	tình huống
revise	đọc lại, xem lại, sửa lại, ôn lại
success	sự thành công
authority	thẩm quyền
creature	sinh vật
shocking	gây ra căm phẫn, tồi tệ, gây kích động
child	đứa trẻ
legislature	cơ quan lập pháp
regional	khu vực
young	trẻ
instrument	dụng cụ
gasoline	xăng
medium	Trung bình
remove	tẩy
fatal	gây tử vong
hormone	hoocmon
wisdom	sự khôn ngoan
psychology	tâm lý học
treasure	kho báu
airline	hãng hàng không
ridge	cây rơm
live	trực tiếp
uncertain certain	không chắc chắn, khôn biết rõ ràng
sexy	sexy
victory	chiến thắng
mobile	di động
perform	biểu diễn
evolution	sự phát triển
peak	cao điểm
halfway	nửa chừng
portrait	Chân dung
with	với
complaint	lời phàn nàn
service	dịch vụ
coffee	cà phê
there	ở đó
lady	quý bà
analyst	nhà phân tích
magazine	tạp chí
pocket	bỏ túi
offense	xúc phạm
channel	kênh
focus	tiêu điểm
invisible	vô hình
favorable	thuận lợi
changing	thay đổi
entire	toàn bộ
approach	tiếp cận
wrist	cổ tay
pen	cây bút
e-mail	e-mail
kilogram	kilôgam
per	mỗi
write	viết
pet	vật nuôi
wage	tiền lương
fiber	chất xơ
period	giai đoạn
proceed	tiếp tục
musical	âm nhạc
bulb	bóng đèn
corporation	tập đoàn
loyalty	lòng trung thành
oh exclamation	chao, ôi chao, chà, này..
understand	hiểu không
birth	Sinh
dismiss	bỏ qua
classroom	phòng học
underlying	cơ bản
slowly	chậm rãi
heaven	thiên đường
jointly	cùng nhau, cùng chung
intelligence	Sự thông minh
ever	không bao giờ
unhappy	không vui
winner	người chiến thắng
million	triệu
even	cũng
install	cài đặt, dựng lên
strongly	mạnh mẽ
analyze	phân tích
integration	hội nhập
restriction	sự hạn chế
yours sincerely	bạn chân thành của anh, chị..
indication	dấu hiệu
bulk	số lượng lớn
tv television	vô tuyến truyền hình
bull	con bò
champion	quán quân
engaged	đã đính ước, đã hứa hôn; đã có người
gun	súng
hundred	hàng trăm
wait	chờ đợi
circuit	mạch
American	Người Mỹ
queen	nữ hoàng
gut	ruột
guy	chàng
restrict	giới hạn
instant	tức thời
disgusted	chán ghét, phẫn nộ
injured	bị tổn thương, bị xúc phạm
native	tự nhiên
peer	ngang nhau
costly	tốn kém
documentary	phim tài liệu
monday	thứ 2
violence	bạo lực
consequence	hậu quả
particularly	đặc biệt
dominant	có ưu thế
worrying	gấy lo lắng, gây lo nghĩ
peel	lột vỏ
granddaughter	cháu gái
driveway	đường lái xe
framework	khuôn khổ
curiously	tò mò, hiếu kỳ, lạ kỳ
entity	thực thể
tide	thủy triều
prohibit	cấm
tonight	tối nay
franchise	nhượng quyền thương mại
bacteria	vi khuẩn
almost	hầu hết
arrow	mũi tên
equally	bằng nhau
manner	cách thức
look at	nhìn, ngắm, xem
at first	trực tiếp
pie	chiếc bánh
associate	liên kết
harmful	gây tai hại, có hại
rather than	hơn là
pig	con lợn
ice cream	kem
wake	đánh thức
judgment	phán đoán
pin	ghim
charity	từ thiện
whether	liệu
pit	hố
mineral	khoáng sản
sneak	sneak
stock	cổ phần
suspend	đình chỉ
beneath	ở trên
terror	khủng bố
everyone	tất cả mọi người
ritual	lễ nghi
liability	trách nhiệm pháp lý
have to modal	phải
basis	nền tảng
army	quân đội
senator	thượng nghị sĩ
girlfriend	bạn gái
clinical	lâm sàng
snow	tuyết
arms	vũ khí, binh giới, binh khí
gym	phòng thể dục
evil	tà ác
governor	thống đốc
rarely	ít khi
basic	căn bản
lake	hồ
twist	xoắn
locate	định vị
unite	thống nhất
bush	cây bụi
fruit	trái cây
prisoner	Tù nhân
cause	nguyên nhân
combat	chống lại
accidentally	tình cờ, ngẫu nhiên
unity	thống nhất
pursue	theo đuổi
twentieth	hai mươi
intended	có ý định, có dụng ý
busy	bận
convey	chuyên chở
design	thiết kế
extra	thêm
friday	thứ sáu
land	đất đai
working	đang làm việc
victim	nạn nhân
Cuban	Cuba
skull	sọ
department	bộ phận
lane	lane
pastor	mục sư
burn	đốt cháy
garlic	tỏi
predator	người ăn thịt
chief	giám đốc
countryside	miền quê, miền nông thôn
aircraft	phi cơ
automatic	tự động
lamp	đèn
satisfying	đem lại sự thỏa mãn, làm thỏa mãn, làm vừa ý
despite	mặc dù
consecutive	liên tiếp
burning	đốt
English	Anh
jewellery	nữ trang, kim hoàn
zero number	số không
bury	chôn
conduct	hạnh kiểm
obey	vâng lời, tuân theo, tuân lệnh
look for	tìm kiếm
fantastic	tuyệt diệu
interested	quan tâm
tidy	sạch sẽ, ngăn nắp, gọn gàng; làm cho sạch sẽ, gọn gàng, ngăn nắp
formerly	trước kia
wall	Tường
walk	đi bộ
policeman	cảnh sát
quietly	lặng lẽ
marry	kết hôn
decay	tình trạng suy tàn, suy sụp, tình trạng đổ nát
advertising	quảng cáo
discussion	thảo luận
liberty	tự do
championship	chức vô địch
Hispanic	Người Hispanic
meeting	gặp gỡ
welcome	chào mừng
drift	trôi dạt
give sth away	cho, phát
chaos	hỗn loạn
separately	không cùng nhau, thành người riêng, vật riêng
want	muốn
forecast	sự dự đoán, dự báo; dự đoán, dự báo
thickly	dày; dày đặc; thành lớp dày
uncover	khám phá
recognize	nhìn nhận
warehouse	Kho
processor	bộ vi xử lý
bad-tempered	xấu tính, dễ nổi cáu
input	đầu vào
difference	Sự khác biệt
reality	thực tế
must	phải
demonstration	trình diễn
molecule	phân tử
offend	xúc phạm, làm bực mình, làm khó chịu
circle	vòng tròn
butt	mông
in exchange	trong việc trao đổi về
resign	từ chức
sophisticated	tinh vi
neatly	gọn gàng, ngăn nắp
aluminum	nhôm
chase	đuổi theo
prize	giải thưởng
accident	Tai nạn
marine	biển
anyway	dù sao
pop	nhạc pop
hairdresser	thợ làm tóc
found	tìm
routine	công Việt Hằng ngày
excuse	tha
pot	nồi
defense	phòng thủ
currency	tiền tệ
escape	thoát khỏi
born: be born	sinh, đẻ
convict	tù nhân
emerging	mới nổi
funny	buồn cười
latest	muộn nhất, chậm nhất, gần đây nhất
receive	nhận được
intimate	thân mật
disclose	tiết lộ
entirely	hoàn toàn
religion	tôn giáo
diagram	biểu đồ
standing	đứng
charm	quyến rũ
tragedy	bi kịch
chart	đồ thị
fridge	tủ lạnh
friendship	hữu nghị
till	cho đến
attend	tham gia
goods	của cải, tài sản, hàng hóa
voting	bầu cử
accounting	kế toán
anymore	nữa không
secure	đảm bảo
unhappiness happiness	sự buồn, nỗi buồn
disappointed	thất vọng
late	muộn
school	trường học
continue	tiếp tục
basically	về cơ bản
tile	ngói
hat	nón
inherent	vốn có
realize	nhận ra
brush	chải
given	được
definite	xác định, định rõ, rõ ràng
last	Cuối cùng
adapt	phỏng theo
wash	rửa
weight	cân nặng
cheerful	vui mừng, phấn khởi, hồ hởi
uncomfortable	khó chịu
pro	pro
allegedly	bị cáo buộc
warn	cảnh báo
warm	ấm áp
exaggerated	cường điệu, phòng đại
guilty	tội lỗi
measure	đo
institutional	thể chế
receipt	công thức; đơn thuốc
coastal	duyên hải
swim	bơi
basement	tầng hầm
curved	cong
impossible	Không thể nào
effort	cố gắng
video	video
dried	khô
surroundings	vùng xung quanh, môi trường xung quanh
wave	làn sóng
anything	bất cứ điều gì
agriculture	nông nghiệp
yesterday	hôm qua
weapon	vũ khí
minimal	tối thiểu
retired	nghỉ hưu
steady	vững chắc
vote	bỏ phiếu
early	sớm
unlike like	không giống, khác
disease	dịch bệnh
yes	Vâng
yet	chưa
technician	kỹ thuật viên
engineer	kỹ sư
endorse	chứng thực
alike	như nhau
genius	Thiên tài
colour	màu sắc; tô màu
infrastructure	cơ sở hạ tầng
typical	điển hình
initially	ban đầu
time	thời gian
tray	cái mâm
shadow	bóng
make sure	chắc chắn, làm cho chắc chắn
happy	vui mừng
program	chương trình
infant	trẻ sơ sinh
put	đặt
artifact	đồ tạo tác
her	cô ấy
offence	sự vi phạm, sự phạm tội
carbon	carbon
unload	cất gánh nặng, dỡ hàng
trap	bẩy
hey	Chào
struggle	đấu tranh
okay	đuợc
lesson	bài học
heritage	gia tài
ambulance	xe cứu thương, xe cấp cứu
philosophy	triết học
slope	dốc
junior	em
light	ánh sáng
passenger	hành khách
terrific	khủng khiếp
apparently	dường như
tiny	nhỏ bé
worship	sự tôn thờ, sự tôn sùng; thờ, thờ phụng, tôn thờ
lawn	bãi cỏ
valuable	quý giá
look forward to	mong đợi cách hân
infection	nhiễm trùng
artist	họa sĩ
make-up	đồ hóa trang, son phấn
lazy	lười biếng
tourism	du lịch
alien	người ngoài hành tinh
layer	lớp
smart	thông minh
triangle	hình tam giác
tourist	du lịch
elite	ưu tú
suburban	ngoại ô
helmet	mũ bảo hiểm
theme	chủ đề
confusing	khó hiểu, gây bối rối
smash	đập, vỡ tan thành mảnh; sự đập, vỡ tàn thành mảnh
tire	lốp xe
barrel	thùng
editor	người biên tập
chain	chuỗi
desire	khao khát
efficient	hiệu quả
chair	cái ghế
unfortunately	không may
consistent	thích hợp
lately	gần đây
reverse	đảo ngược
tennis	quần vợt
sword	thanh kiếm
earnings	thu nhập
january	tháng giêng
chat	nói chuyện, tán gẫu; chuyện phiếm, chuyện gẫu
permanent	dài hạn
foster	nuôi dưỡng
organized	tổ chức
garden	vườn
choice	lựa chọn
travel	du lịch
facility	cơ sở
small	nhỏ bé
beam	chùm tia
beak	mỏ chim
civilization	nền văn minh
before	trước
fiction	viễn tưởng
replace	thay thế
appointment	cuộc hẹn
stomach	Dạ dày
him	anh ta
hip	hông
listen	nghe
Austria	nước Áo
hit	đánh
his	của anh ấy
major	chính
beat	tiết tấu
emphasis	nhấn mạnh
interrupt	làm gián đoạn
worldwide	trên toàn thế giới
bear	chịu
grandfather	ông nội
consider	xem xét
potential	tiềm năng
bean	hạt đậu
group	nhóm
repeatedly	nhiều lần
gross	Tổng
porch	hiên nhà
workshop	xưởng
resist	kháng cự
straighten	làm thẳng
tree	cây
history	lịch sử
stimulate	kích thích
careless	sơ suất, cầu thả
square	Quảng trường
twice	hai lần
soak	ngâm
absolutely	chắc chắn rồi
soar	bay lên
deserted	hoang vắng, không người ở
managing	quản lý
sustain	duy trì
soap	xà bông
classify	phân loại
request	yêu cầu
colony	thuộc địa
wagon	toa xe
their	họ
point	điểm
banking	ngân hàng
debut	ra mắt
general	chung
september	tháng 9
frighten	làm sợ, làm hoảng sợ
hospital	bệnh viện
dimension	kích thước
wildlife	động vật hoang dã
ceiling	Trần nhà
deserve	xứng đáng
process	quá trình
restore	phục hồi
alternative	thay thế
chef	đầu bếp
clear	trong sáng
eighth	thứ tám
crowded	Đông người
of course	dĩ nhiên
encounter	gặp gỡ
clean	dọn dẹp
meal	bữa ăn
sock	bít tất
approve	tán thành
mean	nghĩa là
neither	cũng không
glad	vui vẻ
meat	thịt
chew	nhai
hurry	vội
account	tài khoản
attendance	sự tham dự
developmental	phát triển
sometime	thỉnh thoảng
mostly	chủ yếu
innocent	vô tội
beef	thịt bò
alphabet	bảng chữ cái, bước đầu, điều cơ bản
advance	nâng cao
evaluation	đánh giá
trip	chuyến đi
appreciate	đánh giá
trim	cắt tỉa
diverse	phong phú
killer	sát thủ
find out sth	khám phá, tìm ra
hunting	săn bắn
strict	nghiêm khắc
beer	bia
rally	biểu tình
safely	an toàn
you	bạn
jump	nhảy
knowledge	hiểu biết
soft	mềm mại
prime	nguyên tố
happen	xảy ra
sofa	ghế sô pha
festival	lễ hội
loyal	trung thành
preference	sở thích
delighted	vui mừng, hài lòng
mainstream	dòng chính
active	đang hoạt động
july	tháng 7
opportunity	cơ hội
court	tòa án
Olympic	Olympic
venture	liên doanh
population	dân số
enthusiasm	hăng hái
route	lộ trình
African-American	Người Mỹ gốc Phi
flexible	linh hoạt
used to sth/to doing sth	sử dụng cái gì, sử dụng để làm cái gì
organ	đàn organ
mirror	gương
depict	miêu tả
sustainable	bền vững
unwilling	không sẵn lòng, miễn cưỡng
soil	đất
bottle	chai
hot	nóng bức
characteristic	đặc trưng
interior	Nội địa
how	làm sao
capability	khả năng
involvement	sự tham gia
spark	tia lửa
farming	công việc trồng trọt, đồng áng
assembly	hội,, tổ hợp
hearing	thính giác
wedding	lễ cưới
parental	cha mẹ
spare	phụ tùng
chip	Chip
chin	cái cằm
tail	đuôi
emotional	đa cảm
thursday	thứ 5
pistol	súng lục
assemble	tập hợp
noticeable	đáng chú ý, đáng để ý
march	tháng Ba
transition	quá trình chuyển đổi
blast	vụ nổ
give up	bỏ, từ bỏ
mutter	lẩm bẩm
june	tháng 6
answer	câu trả lời
meet	gặp
series	loạt
thrive	phát đạt
purse	cái ví
represent	đại diện
compete	cạnh tranh
celebrity	người nổi tiếng
thickness	tính chất dày, độ dày, bề dày
sometimes	đôi khi
leave out	bỏ quên, bỏ sót
listener	người nghe
promise	lời hứa
hold	giữ
tale	câu chuyện
correctly	đúng
trail	đường mòn
prior	trước
rubber	cao su
trait	đặc điểm
underwear	quần lót
talk	nói chuyện
tall	cao
landmark	mốc
reply	Đáp lại
vanish	biến mất
give birth	sinh ra
train	xe lửa
coordinator	điều phối viên
commonly	thông thường
planet	hành tinh
count	đếm
scholar	học giả
take	lấy
vision	tầm nhìn
accompany	đi kèm
immediate	ngay lập tức
blame	khiển trách
relatively	tương đối
reckon	tính, đếm
confusion	sự nhầm lẫn
some	một số
blank	chỗ trống
beginning	bắt đầu
session	phiên họp
additional	bổ sung
primarily	chủ yếu
soften	làm mềm
reception	tiếp nhận
tank	xe tăng
just	chỉ
bloody	dính máu
notice	để ý
owner	chủ nhân
sole	Duy Nhất
Mexican	Mexico
midnight	nữa đêm
jury	ban bồi thẩm
grandson	cháu trai
holy	thánh
monitor	giám sát
Soviet	Liên Xô
strictly	nghiêm khắc
home	nhà
hole	lỗ
existing	hiện tại
print	in
although	mặc dù
approximately	xấp xỉ
material	vật chất
encouragement	niềm cổ vũ, động viên, khuyến khích, sự làm can đảm
spectacular	đẹp mắt
iron	bàn là
diplomat	nhà ngoại giao
huh	Huh
hug	ôm
president	chủ tịch
explain	giải thích
basket	cái rổ
hope	mong
go up	đi lên
soon	Sớm
executive	điều hành
tablet	tấm, bản, thẻ phiến
hook	cái móc
melt	tan chảy
tape	băng
bend	bẻ cong
action	hoạt động
stadium	sân vận động
casualty	tai nạn
song	bài hát
belt	thắt lưng
chop	chặt
cream	kem
protest	phản đối
sensitive	nhạy cảm
Japanese	tiếng Nhật
bell	chuông
heavy	nặng
afford	đủ khả năng
underground	dưới mặt đất, ngầm dưới đất; ngầm
biological	sinh học
impression	ấn tượng
machinery	máy móc, thiết bị
unpleasant	không dễ chịu, khó chịu, khó ưa
Persian	Người Ba Tư
deliver	giao hàng
phenomenon	hiện tượng
summer	mùa hè
eight	tám
trailer	trailer
file	tập tin
in charge of	phụ trách
member	hội viên
disapprove	không tán thành, phản đối, chê
together	cùng với nhau
illness	bệnh
faucet	vòi
socially	xã hội
within	bên trong
could	có thể
hoever	ai, người nào, bất cứ ai, bất cứ người nào, dù ai
bent	khiếu, sở thích, khuynh hướng
strike	đình công
health	Sức khỏe
positive	tích cực
trigger	cò súng
menu	thực đơn
rental	thuê
o'clock	giờ
prospect	khách hàng tiềm năng
radar	radar
machine	máy móc
refugee	người tị nạn
able	có thể
efficiently	có hiệu quả, hiệu nghiệm
evening	tối
workplace	nơi làm việc
return	trở về
specialize	chuyên môn hóa
rotate	Quay
instance	ví dụ
concerned	liên quan
conscience	lương tâm
practically	thực tế
serve	phục vụ
short-term	thời gian ngắn
cough	ho, sự ho, tiếng hoa
drown	chết chìm
blade	lưỡi
radio	radio
smile	nụ cười
confused	bối rối, lúng túng, ngượng
make fun of	đùa cợt, chế giễu, chế nhạo
solution	dung dịch
fine	khỏe
find	tìm thấy
opponent	phản đối
host	chủ nhà
accelerate	đẩy nhanh
anti- prefix	chống lại
backward	về phía sau, lùi lại
dramatically	đột ngột
international	quốc tế
regardless	bất kể
selected	đã chọn
upward	lên, hướng lên, đi lên
citizen	công dân
take  over	chở, chuyển cái gì; tiếp quản, kế tục cái gì
illustrate	Minh họa
occur	xảy ra
pleasant	dễ chịu
relaxing	làm giảm, bớt căng thẳng
a bit	một chút, một tí
difficult	khó khăn
breeze	khoe khoang
film	phim ảnh
seriously	nghiêm túc
sort	sắp xếp
fill	lấp đầy
dentist	nha sĩ
heart	tim
trash	rác
painter	họa sĩ
millimetre	mi-li-met
forget	quên
professor	Giáo sư
convenient	tiện lợi, thuận lợi, thích hợp
horn	sừng
task	bài tập
specialist	chuyên gia
transit	quá cảnh
true	đúng, thật
adolescent	thanh niên
sore	đau, nhức
valley	thung lũng
position	Chức vụ
present	hiện tại
curtain	tấm màn
laughter	tiếng cười
softly	nhẹ nhàng
since	kể từ
Congress	Hội nghị
sentiment	tình cảm
soup	Súp
belong	thuộc về
patent	bằng sáng chế
soul	Linh hồn
certificate	giấy chứng nhận, bằng, chứng chỉ
dangerous	nguy hiểm
best	tốt
mess	lộn xộn
sour	chua, có vị giấm
transform	biến đổi
rented	được thuê, được mướn
hour	giờ
advise	khuyên nhủ
competitor	đối thủ
leadership	khả năng lãnh đạo
magnitude	độ lớn
troubled	gặp rắc rối
genuine	chính hãng
mid- combining form	tiền tố: một nửa
experienced	có kinh nghiệm
certainly	chắc chắn
execution	chấp hành
immune	miễn dịch
spokesman	người phát ngôn
equation	phương trình
impressive	ấn tượng
compound	hợp chất
shocked	bị kích động, bị va chạm, bị sốc
master	bậc thầy
extraordinary	bất thường
concerning	có liên quan
attraction	sức hút
the definite article	cái, con, người, ấy này....
conventional	thông thường
regulation	Quy định
complicate	làm phức tạp, rắc rối
puzzle	câu đố
accommodation	sự thích nghi, điều tiết
evident	hiển nhiên
mere	chỉ là
online	Trực tuyến
suburb	ngoại ô
writer	nhà văn
fence	hàng rào
coming	đang đến
annoy	chọc tức, làm bực mình; làm phiền, quẫy nhiễu
glue	keo, hồ; gắn lại, dán bằng keo, hồ
United	United
scream	hét lên
cover	che
theatre	rạp hát, nhà hát
firm	chắc chắn
reflect	phản chiếu
contribution	sự đóng góp
coughing	ho
have auxiliary	có
ongoing	đang diễn ra
outfit	trang phục
fire	ngọn lửa
runner	người chạy
symbolic	tượng trưng
in memory of	sự tưởng nhớ
distinguish	phân biệt
spray	Xịt nước
taxi	xe tắc xi
decorative	để trang hoàng, để trang trí, để làm cảnh
something	cái gì đó
vitamin	vitamin
intention	ý định
pointed	nhọn, có đầu nhọn
enthusiastic	hăng hái, say mê, nhiệt tình
row name	hàng, dãy
rude	bất lịch sự, thô lỗ; thô sơ, đơn giản
symptom	triệu chứng
thereby	bằng cách ấy
funeral	tang lễ
processing	Chế biến
except	ngoại trừ
impulse	thúc đẩy
foreigner	người nước ngoài
infectious	lây, nhiễm
religious	Tôn giáo
shower	vòi hoa sen
functional	chức năng
nevertheless	Tuy nhiên
saturday	thứ 7
fact	thực tế
prominent	nổi bật
fundamental	căn bản
global	toàn cầu
fist	nắm tay
entitle	quyền lợi
outline	đề cương
counselor	cố vấn
fade	phai màu
unless	trừ khi
temperature	nhiệt độ
perspective	quan điểm
operating	điều hành
free	miễn phí
galaxy	Thiên hà
equality	bình đẳng
ought	nên
honour	danh dự, thanh danh, lòng kính trọng
invade	xâm chiếm
reaction	phản ứng
trousers	quần
thorough	cẩn thận, kỹ lưỡng
knitting	việc đan; hàng dệt kim
people	những người
democracy	dân chủ
actually	thực ra
evolve	phát triển
face	đối mặt
abandon	từ bỏ
afraid	sợ
fish	cá
household	hộ gia đình
invite	mời gọi
operation	hoạt động
ratio	tỉ lệ
calculation	phép tính
alarming	làm lo sợ, làm hốt hoảng, làm sợ hãi
instinct	bản năng
afterward	sau đó
reputation	uy tín
ice	Nước đá
shrug	nhún vai
independence	độc lập
inside	phía trong
mainly	chủ yếu
motorcycle	xe mô tô
presentation	trình bày
whenever	bất cứ khi nào
awkward	vụng về, lung túng
five	số năm
ruin	phá hoại
cheaply	rẻ, rẻ tiền
impatient	thiếu kiên nhẫn, nóng vội
celebrate	ăn mừng
spill	tràn
please	xin vui lòng
collection	bộ sưu tập
finding	Phát hiện
hunger	đói
opposed to	chống lại, phản đối
squad	đội hình
laboratory	phòng thí nghiệm
Latin	Latin
campaign	chiến dịch
look after	trông nom, chăm sóc
vital	quan trọng
conflict	cuộc xung đột
loudly	ầm ĩ, inh ỏi
rough	thô
lawsuit	kiện tụng
father	cha
detect	phát hiện
rule	qui định
update	cập nhật
condemn	lên án
get off	ra khỏi, thoát khỏi
assistance	hỗ trợ
poem	bài thơ
definition	Định nghĩa
poet	bài thơ
wonder	ngạc nhiên
every	mỗi
sit down	ngồi xuống
mansion	biệt thự
shave	cạo
summary	tóm lược
again	lần nữa
refuge	nơi ẩn náu
dramatic	kịch tính
taxpayer	người nộp thuế
spine	xương sống
theology	thần học
indeed	thật
guitar	đàn ghi ta
artificial	nhân tạo
imaginary	tưởng tượng, ảo
removal	gỡ bỏ
comment	bình luận
employ	thuê
folding	gấp lại được
during	suốt trong
fair	hội chợ
Asian	Châu Á
consist	bao gồm
preparation	chuẩn bị
critic	nhà phê bình
grammar	văn phạm
enable	cho phép
price	giá bán
safety	an toàn
defensive	phòng ngự
slavery	chế độ nô lệ
decoration	sự trang hoàng, đồ trang hoàng, trang trí
dependent	phụ thuộc
profession	chuyên nghiệp
briefly	ngắn gọn
arise	nảy sinh
agree	đồng ý
swelling	sự sưng lên, sự phồng ra
imagination	trí tưởng tượng
resistance	sức đề kháng
underneath	dưới, bên dưới
dancer	vũ công
fail	Thất bại
enjoyment	sự thích thú, sự có được, được hưởng
itself	chinh no
enjoyable	thú vị, thích thú
spectrum	quang phổ
anyone	bất kỳ ai
pride	tự hào
breakfast	bữa ăn sáng
favorite	yêu thích
broadcast	phát sóng
steel	Thép
steep	dốc
thumb	ngón tay cái
seize	tịch thu
church	nhà thờ
classical	cổ điển
isolated	bị cô lập
privilege	đặc quyền
feel sick	buồn nôn
substitute	người, vật thay thế; thay thế
foreign	ngoại quốc
uniform	đồng phục
fall	ngã
moreover	hơn thế nữa
mysterious	huyền bí
scatter	tiêu tan
violate	xâm phạm
collective	tập thể
steer	chỉ đạo
event	biến cố
buddy	Bạn bè
undergo	trải qua
wherever	ở đâu
finger	ngón tay
agency	đại lý
railroad	đường sắt
homework	bài tập về nhà
fascinating	hấp dẫn
abstract	trừu tượng
agenda	chương trình nghị sự
nice	tốt đẹp
appearance	xuất hiện
liquid	chất lỏng
culture	nền văn hóa
anonymous	vô danh
cannot	không thể
fisherman	ngư dân
first	Đầu tiên
need modal	cần, đòi hỏi; sự cần
perfect	hoàn hảo
prefer	thích hơn
fewer	ít hơn
clearly	thông suốt
poll	thăm dò ý kiến
minority	thiểu số
pole	cây sào
tight	chặt chẽ
space	không gian
waiter, waitress	người hầu bàn, người đợi, người trông chờ
reference	tài liệu tham khảo
conspiracy	âm mưu
chamber	buồng
spite	bất bình
arrange	sắp xếp
theater	rạp hát
nephew	cháu trai
Spanish	người Tây Ban Nha
from	từ
publicity	công khai
depart	khởi hành
bench	Băng ghế
bottom	đáy
ill	bệnh
commitment	cam kết
finished	hoàn tất, hoàn thành
poke	xô
covered	có mái che, kín đáo
speaker	loa
publisher	nhà xuất bản
fame	danh tiếng
intervention	can thiệp
replacement	thay thế
pond	ao
repair	sửa
the rest	vật, cái còn lại, những người, cái khác
could modal	có thể
death	tử vong
steak	miếng bò hầm
arrival	sự đến
steal	lấy trộm
advice	khuyên bảo
according	theo
frequent	Thường xuyên
interact	tương tác
membership	thành viên
powder	bột
error	lỗi
network	mạng
terrorist	khủng bố
jealous	ghen,, ghen tị
seemingly	có vẻ
trace	dấu vết
paper	giấy
public	công cộng
array	mảng
terrorism	khủng bố
nominee	ứng cử viên
steam	hơi nước
track	theo dõi
value	giá trị
fortune	vận may
quantity	số lượng
ink	mực
rush	vội vã
expensive	đắt
performance	hiệu suất
trade	buôn bán
currently	hiện tại
round	tròn
ambassador	đại sứ
growth	sự phát triển
weave	dệt
carrot	cà rốt
normally	bình thường
fare	giá vé
bicycle	Xe đạp
accuracy	tính chính xác
resolution	độ phân giải
building	Tòa nhà
spouse	vợ / chồng
setting	cài đặt
properly	đúng
score	ghi bàn
quote	Trích dẫn
graduate	tốt nghiệp
poor	nghèo nàn
farm	nông trại
terrain	địa hình
grief	đau buồn
ashamed	ngượng, xấu hổ
unlikely	không chắc
rat	con chuột
excellent	Xuất sắc
virtually	hầu như
fairly	công bằng
pool	bơi
raw	thô
lighting	thắp sáng
sprinkle	rắc
airport	sân bay
cultural	văn hoá
exam	thi
Islam	đạo Hồi
municipal	thành phố
institute	viện, học viện
endure	chịu đựng
placement	vị trí
poster	áp phích
hobby	sở thích riêng
shortly	ngay
firmly	vững chắc
southern	phía Nam
criterion	tiêu chuẩn
fate	số phận
throat	họng
essence	Bản chất
unkind	độc ác, tàn nhẫn
manual	sổ tay
pork	thịt heo
uncertainty	tính không chắc chắn
dollar	đô la mỹ
rolling	lăn
French	người Pháp
vocabulary	từ vựng
retire	về hưu
aspect	khía cạnh
unsteady steady	không đúng mực, không vững, không chắc
aggressive	xâm lược
God	thần
close	gần
chemistry	hóa học
photo	hình chụp
embarrassment	sự lúng túng, sự bối rối
swing	lung lay
fast	Nhanh
invasion	cuộc xâm lăng
workout	tập thể dục
loosely	lỏng lẻo
spin	quay
grocery	tạp hóa
shallow	nông
spit	nhổ
register	ghi danh
fleet	hạm đội
nine	chín
couple	vợ chồng
Russian	Người Nga
communicate	giao tiếp
rural	nông thôn
blonde	hoe vàng, mái tóc hoe vàng
fortunately	may mắn
acid	axit
red	đỏ
act	hành động
transmission	truyền tải
agricultural	nông nghiệp
post	bài đăng
duck	con vịt
offender	tội phạm
shortage	sự thiếu
finish	hoàn thành
add	thêm vào
educational	giáo dục
pose	đặt ra
its	của nó
wrapping	vật bao bọc, vật quấn quanh
consent	bằng lòng
article	bài báo
respect	sự tôn trọng
shelf	kệ
retreat	rút lui
mutual	lẫn nhau
port	Hải cảng
shell	vỏ
mobile phone	điện thoại đi động
therefore	vì thế
adjustment	điều chỉnh
exchange	trao đổi, giao dịch
hesitate	do dự
go wrong	mắc lỗi, sai lầm
rifle	súng trường
income	thu nhập
trust	Lòng tin
production	sản xuất
united	liên minh, đoàn kết, chung, thống nhất
choose	chọn
jeans	Quần jean
peaceful	bình yên
overnight	qua đêm
prevent	ngăn chặn
behave	hành xử
undo	tháo, gỡ; xóa bỏ, hủy bỏ
disturbing	phiền
laser	laser
previously	trước đây
happiness	hạnh phúc
mixture	hỗn hợp
sorry	lấy làm tiếc
pasta	mỳ ống
scope	phạm vi
can modal	có thể; nhà tù, nhà giam, bình, ca đựng
democratic	dân chủ
surveillance	giám sát
embrace	ôm hôn
identify	nhận định
citizenship	quyền công dân
pour	đổ
northeast	đông bắc
one number,	một; một người, một vật nào đó
label	nhãn
improvement	cải tiến
message	thông điệp
modify	sửa đổi
truth	sự thật
age	tuổi tác
feminist	nữ quyền sĩ
aesthetic	thẩm mỹ
college	trường đại học
prime minister	thủ tướng
movie	bộ phim
tendency	khuynh hướng
ago	trước
rib	xương sườn
rid	thoát khỏi
carbohydrate	carbohydrate
variation	biến thể
number	con số
disappointment	thất vọng
punish	trừng phạt
reinforce	củng cố
casual	giản dị
odds	tỷ lệ
rim	rim
decline	từ chối
property	bất động sản
rip	Yên nghỉ
strangely	lạ, xa lạ, chưa quen
debris	mảnh vụn
Catholic	Công giáo
nothing	không có gì
testing	thử nghiệm
whistle	sự huýt sáo, sự thổi còi; huýt sáo, thổi còi
handle	xử lý
isolation	cô lập
tough	khó khăn
script	kịch bản
exit	lối thoát
happily	hạnh phúc
system	hệ thống
likelihood	khả năng
spot	nơi
silver	bạc
aid	viện trợ
partial	một phần
blessing	phước lành
other	khác
generously	rộng lượng, hào phóng
aim	mục đích
city	thành phố
confident	tự tin
uncle	Chú
retain	giữ lại
air	không khí
skilled	có kỹ năng
courage	lòng can đảm
educator	nhà giáo dục
local	địa phương
retail	bán lẻ
crew	phi hành đoàn
defeat	đánh bại
accommodate	chứa
bubble	bong bóng
steadily	liên tục
yield	năng suất
electronic	điện tử
promptly	mau lẹ, ngay lập tức
vacation	kỳ nghỉ
speak	nói
outcome	kết quả
sacred	Linh thiêng
tender	đấu thầu
infected	bị nhiễm, bị đầu độc
historian	nhà sử học
curriculum	chương trình giáo dục
satisfaction	sự thỏa mãn
meantime	thời gian chờ đợi
boat	thuyền
demographic	nhân khẩu học
powerful	quyền lực
future	Tương lai
atop	trên
cite	trích dẫn
atom	nguyên tử
movement	phong trào
royal	hoàng tộc
shed	đổ ra
glove	găng tay
impressed	được ghi, khắc, in sâu vào
rating	Xêp hạng
body	thân hình
mode	chế độ
rear	phía sau
cage	cái lồng
insect	côn trùng
qualify	đủ tiêu chuẩn
pregnant	có thai
all	tất cả các
always	luôn luôn
border	biên giới
read	đọc
already	đã
touch	chạm
admission	nhận vào
clock	đồng hồ
real	thực
expense	chi phí
rumour	tin đồn, lời đồn
unit	đơn vị
contemporary	đồng thời
monthly	hàng tháng
sensor	cảm biến
credit card	thẻ tín dụng
collect	sưu tầm
gear	Hộp số
badly	tệ
facilitate	tạo điều kiện
entertaining	giải trí
rob	cướp, lấy trộm
rod	gậy
dumb	ngớ ngẩn
favour	thiện ý, sự quý mến; sự đồng ý; sự chiếu cố
disappoint	không làm thỏa ước nguyện, ý mong đợi; thất ước, làm thất
weakness	yếu đuối
and	và
today	hôm nay
touchdown	đụng
construction	xây dựng
predict	tiên đoán
dump	đổ
row	hàng
universal	phổ cập
chemist	nhà hóa học
abroad	ở nước ngoài
fifteen	mười lăm
guilt	tội lỗi
undermine	phá hoại
deliberately	thong thả
radical	cấp tiến, căn nguyên
unnecessary	không cần thiết, không mong muốn
any	bất kì
minute	phút
ladder	thang
application	ứng dụng
productive	có năng suất
until	cho đến
formally	chính thức
hypothesis	giả thuyết
collapse	sự sụp đổ
dull	chậm hiểu, ngu đần
reason	lý do
accurate	chính xác
thought	nghĩ
legend	huyền thoại
prosecution	truy tố
taste	nếm thử
gambling	trò cờ bạc
ship	tàu
anywhere	ở đâu
identification	nhận biết
cake	bánh ngọt
jam	mứt
protein	chất đạm
annual	hàng năm
exclusive	độc quyền
jar	lọ
gentle	dịu dàng
poverty	nghèo nàn
sweater	áo len
resort	phương sách
testify	làm chứng
boil	sôi lên
shopping	mua sắm
lightning	sét đánh
jaw	hàm
devoted	hiến cho, dâng cho, dành cho; hết lòng, nhiệt tình
margin	lề
nail	móng tay
pregnancy	mang thai
demand	nhu cầu
mount	gắn kết
toilet	phòng vệ sinh
turkey	gà tây
gently	dịu dàng
grade	cấp
letter	lá thư
centimetre	xen ti met
philosophical	triết học
telescope	kính viễn vọng
corruption	tham nhũng
photography	nhiếp ảnh
a few	một ít, một vài
annually	hàng năm
accuse	tố cáo
increased	tăng
housing	nhà ở
frequently	thường xuyên
northwest	Tây Bắc
devil	ác quỷ
instructional	hướng dẫn
acquire	có được, thu được
matching	tính địch thù, thi đấu
tactic	chiến thuật
worth	giá trị
automobile	ôtô
diversity	sự đa dạng
in order to	hợp lệ
notion	khái niệm
take advantage of	lợi dụng
uncomfortable comfortable	bất tiện, không tiện lợi
grace	ân sủng
patience	kiên nhẫn
where	Ở đâu
arm	cánh tay
popular	phổ biến
psychologist	nhà tâm lý học
broken	bị hỏng
art	nghệ thuật
curly	quăn, xoắn
lacking	ngu đần, ngây ngô
broker	người môi giới
call	gọi
calm	điềm tĩnh
kick	đá
ownership	sở hữu
shit	dơ bẩn
tumor	khối u
armed	trang bị
ash	tro
ask	hỏi
dilemma	tình trạng khó xử
rub	chà xát
ass	mông
through	xuyên qua
engagement	hôn ước
castle	thành trì, thành quách
strength	sức mạnh
officer	nhân viên văn phòng
reportedly	báo cáo
lifetime	cả đời
justified	hợp lý, được chứng minh là đúng
occasional	thỉnh thoảng
run	chạy
enact	ban hành
bomb	bom
repeated	được nhắc lại, được lặp lại
debate	tranh luận
mother	mẹ
mouse	chuột
either	hoặc
view	lượt xem
vulnerable	dễ bị tổn thương
ours	của chúng tôi
as soon as	ngay khi
preach	rao giảng
jet	máy bay phản lực
yourself	bản thân bạn
donate	hiến tặng
helpful	Hữu ích
dust	bụi bặm
those	những, cái đó
palace	cung điện
worry	lo
telephone	Điện thoại
bold	Dũng cảm
significant	có ý nghĩa
Irish	Người Ailen
camp	trại
difficulty	khó khăn
volunteer	Tình nguyện
everywhere	mọi nơi
senate	thượng nghi viện, ban giám hiệu
name	Tên
bolt	chớp
get on leo	trèo lên
neighborhood	khu vực lân cận
crop	mùa vụ
congressional	quốc hội
Christmas	Giáng Sinh
shop	cửa tiệm
distance	khoảng cách
mood	khí sắc
boom	sự bùng nổ
absence	vắng mặt
attract	thu hút
book	sách
truck	xe tải
show	chỉ
description	sự miêu tả
edition	phiên bản
disappear	biến mất
cracked	rạn, nứt
recession	suy thoái kinh tế
shot	bắn
negative	tiêu cực
pizza	pizza
ally	đồng minh
defend	phòng thủ
arrive	đến nơi
street	đường phố
hence	vì thế
boot	khởi động
shoe	giày
introduce	giới thiệu
substance	vật chất
estimated	ước tính
frown	nhăn mặt
bone	khúc xương
tribal	bộ lạc
bond	liên kết
suddenly	đột ngột
discourse	đàm luận
momentum	Đà
target	Mục tiêu
mouth	miệng
sibling	anh chị em ruột
guidance	hướng dẫn
nervous	lo lắng
restricted	bị hạn chế, có giới hạn; vùng cấm
duty	nhiệm vụ
stranger	lạ
Greek	người Hy Lạp
penny	số tiền
delicate	tinh tế
leader	lãnh đạo
fancy	tưởng tượng, cho, nghĩ rằng; tưởng tượng
yard	sân
rebel	nổi loạn
bounce	tung lên
experimental	thử nghiệm
tissue	mô
rent	thuê
Thanksgiving	Lễ Tạ ơn
cart	xe đẩy
cast	dàn diễn viên
anxious	lo lắng
piano	đàn piano
largely	phần lớn
slice	lát
broad	rộng lớn
princess	công chúa
severely	nghiêm trọng
truly	thực sự
cash	tiền mặt
case	trường hợp
generation	thế hệ
canvas	Tranh sơn dầu
item	mục
stiffly	cứng, cứng rắn, kiên quyết
gene	gen
hollow	rỗng, trống rỗng
downtown	trung tâm thành phố
trunk	Thân cây
wind sth up	lên dây, quấn, giải quyết
saving	nói
sunday	chủ nhật
moon	mặt trăng
phone	điện thoại
rely	dựa
slide	trượt
sticky	dính, nhớt
excessive	quá đáng
style	Phong cách
waist	eo
flesh	xác thịt
jungle	rừng nhiệt đới
card	Thẻ
outsider	người ngoài
care	quan tâm
participation	sự tham gia
assault	tấn công
damage	hư hại
purely	hoàn toàn, chỉ là
boss	trùm
guard	bảo vệ
pattern	mẫu
settle	ổn định
unfriendly friendly	đối địch, không thân thiện
exercise	tập thể dục
harsh	khắc nghiệt
labour	lao động; công việc
vehicle	phương tiện
freedom	sự tự do
physics	vật lý
seldom	ít khi
cooking	nấu nướng
protect	bảo vệ
architecture	kiến trúc
stress	nhấn mạnh
more	hơn
born	sinh ra
display	trưng bày
kill	giết chết
bore	buồn chán, buồn tẻ
beautifully	tốt đẹp, đáng hài lòng
nomination	đề cử
tablespoon	muỗng canh
disorder	rối loạn
broadly	rộng, rộng rãi
noisily	ồn ào, huyên náo
shut	đóng lại
luck	may mắn
navy	hải quân
simple	đơn giản
influence	ảnh hưởng
cloud	đám mây
percentage	phần trăm
talent	năng lực
totally	hoàn toàn
negotiate	đàm phán
speculation	suy đoán
cave	hang
package	gói
crisis	khủng hoảng
marketplace	thương trường
pronunciation	sự phát âm
king	nhà vua
kind	loại
timing	thời gian
in the end	cuối cùng, về sau
temporarily	tạm
unexpected, unexpectedly	bất ngờ, đột ngột, gây ngạc nhiên
both	cả hai
important	quan trọng
most	phần lớn
glimpse	nhìn thoáng qua
detective	thám tử
transfer	chuyển khoản
phrase	cụm từ
veteran	cựu chiến binh
daily	hằng ngày
nerve	dây thần kinh
rudely	bất lịch sự, thô lỗ; thô sơ, đơn giản
aside from	ngoài ra, trừ ra
job	việc làm
daughter	Con gái
cloth	vải
limitation	giới hạn
nonprofit	phi lợi nhuận
sponsor	nhà tài trợ
insert	chèn
captain	đội trưởng
forbid	ngăn cấm
inspiration	cảm hứng
bowl	bát
highlight	Điểm nổi bật
administrator	người quản lý
database	cơ sở dữ liệu
billion	tỷ
joy	vui sướng
patient	bệnh nhân
reject	Từ chối
sad	buồn
sheer	tuyệt
miracle	phép màu
sheet	tấm
depressing	làm chán nản làm thát vọng, làm trì trệ
profit	lợi nhuận
sheep	cừu
rest	nghỉ ngơi
amount	số lượng
move	di chuyển
comply	tuân theo
original	nguyên
album	album
assignment	nhiệm vụ
yawn	há miệng; cử chỉ ngáp
also	cũng thế
sandwich	sandwich
say	Nói
enough	đủ
prosecutor	công tố viên
increase	tăng
kingdom	Vương quốc
differ	khác nhau
spread	Lan tràn
afternoon	buổi chiều
educated	được giáo dục, được đào tạo
favor	ủng hộ
interruption	sự gián đoạn, sự ngắt lời
investigation	cuộc điều tra
latter	sau này
clinic	phòng khám bệnh
depression	Phiền muộn
front	trước mặt
simply	đơn giản
customer	khách hàng
plane	máy bay
equivalent	tương đương
stupid	ngốc nghếch
mentor	người cố vấn
bad	xấu
bag	túi
awake	thức tỉnh
kiss	hôn
ban	lệnh cấm
offer	phục vụ
bar	quán ba
diplomatic	ngoại giao
suffer	đau khổ
bat	gậy
neighbourhood	hàng xóm, làng giềng
saving (PL)	tiết kiệm (PL)
complex	phức tạp
draft	bản nháp
fluid	chất lỏng
bay	bay
rubbish	vật vô giá trị, bỏ đi, rác rưởi
afterwards	sau này, về sau, rồi thì, sau đấy
adequately	tương xứng, thỏa đáng
wrongly	một cách bất công, không đúng
personal	cá nhân
angry	bực bội
accurately	chính xác
plastic	nhựa
delay	sự chậm trễ
globe	quả địa cầu
chemical	hóa chất
plant	thực vật
enquiry	sự điều tra, sự thẩm vấn
drive	lái xe
greatly	rất nhiều
take notice of	chú ý
deal	thỏa thuận
strong	mạnh
abuse	lạm dụng
scheme	kế hoạch
homeland	quê hương
affect	có ảnh hưởng đến
deaf	điếc, làm thinh, làm ngơ
icon	biểu tượng
dead	đã chết
civic	công dân
drain	ráo nước
sea	biển
coldly	lạnh nhạt, hờ hững, vô tâm
sixth	thứ sáu
amuse	làm cho vui, thích, làm buồn cười
isolate	cô lập
sailor	thủy thủ
smoothly	một cách êm ả, trôi chảy
see	xem
servant	người hầu
responsibility	trách nhiệm
civil	dân sự
national	Quốc gia
subsequent	sau đó
indicate	biểu thị
wheat	lúa mì
dear	kính thưa
contain	chứa
set	bộ
sew	may, khâu
founder	người sáng lập
sex	tình dục
column	cột
medicine	dược phẩm
biography	tiểu sử
procedure	thủ tục
sample	mẫu vật
integrate	tích hợp
battle	chiến đấu
admiration	sự khâm phục,người kp, thán phục
gifted	năng khiếu
diagnose	chẩn đoán
fighter	đấu sĩ
somewhat	phần nào
river	con sông
validity	hiệu lực
spider	con nhện
bed	Giường
bee	con ong
beauty	sắc đẹp, vẻ đẹp
beg	ăn xin
deck	boong
no exclamation,	không
be sick	bị ốm
humorous	hài hước, hóm hỉnh
bet	cá cược
in public	giữa công chúng, công khai
parish	giáo xứ
contact	tiếp xúc
useless	vô ích, vô dụng
programming	lập trình
disadvantage	sự bất lợi, sự thiệt hại
metropolitan	đô thị
typically	thường
dishonest	bất lương, không thành thật
garbage	rác thải
suspicious	nghi ngờ
complain	than phiền
anxiety	sự lo ngại
she	chị ấy
adjust	điều chỉnh
western	miền Tây
debt	món nợ
in advance	trước, sớm
party	buổi tiệc
little	ít
deer	con nai
however	Tuy nhiên
lucky	may mắn
deep	sâu
confined	hạn chế, giới hạn
shy	nhát
forgive	tha lỗi
deem	thấy
regulatory	quy định
compel	bắt buộc
capable	có khả năng
depress	làm chán nản, làm phiền muộn; làm suy giảm
parade	diễu hành
collector	người thu gom
uncontrolled control	không bị kiềm chế, không bị kiểm tra
on sb’s behalf	nhân danh cá nhân ai
lemon	Chanh
related	liên quan
trainer	người huấn luyện
aunt	cô dì
await	chờ đợi
client	khách hàng
sin	tội
unfair	không công bằng
sir	Ngài
lump	cục, tảng, miếng; cái bướu
conversion	chuyển đổi
next to	gần
sit	ngồi
ballot	phiếu
over	kết thúc
brilliant	rực rỡ
historic	mang tính lịch sử
living	sống
practical	thiết thực
six	sáu
unacceptable	không thể chấp nhận, không tán thành, không tha thứ; không chịu nổi
eyebrow	lông mày
oven	lò nướng
breathing	thở
bound	nhất định, chắc chắn
false	sai, nhầm, giả dối
obviously	chắc chắn
packaging	bao bì
football	bóng đá
dinner	bữa tối
stroke	Cú đánh
breed	nuôi dưỡng, chăm sóc, giáo dục; sinh đẻ; nòi giống
a little	nhỏ, một ít
cheque	séc
farmer	nông phu
developer	nhà phát triển
realm	cảnh giới
avoid	tránh
bid	BID
fresh	tươi
comprehensive	toàn diện
prompt	nhắc nhở
tunnel	đường hầm
elaborate	kỹ lưỡng
peasant	nông dân
big	lớn
corridor	hành lang
expert	chuyên gia
select	lựa chọn
advanced	nâng cao
crowd	đám đông
bin	thùng, thùng đựng rượu
mechanical	cơ khí
recommendation	sự giới thiệu
cycling	sự đi xe đạp
sick	đau ốm
bit	bit
improved	cải tiến
output	đầu ra
ski	trượt tuyết
thanks	cảm ơn
fatigue	mệt mỏi
striking	nổi bật
convinced	thuyết phục
corner	góc
beside	bên cạnh
majority	đa số
model	mô hình
join	tham gia
costume	trang phục
crown	vương miện, vua, ngai vàng; đỉnh cao nhất
reduce	giảm
sentence	kết án
sky	bầu trời
faithfully	trung thành, chung thủy, trung thực
hallway	hành lang
large	lớn
surface	bề mặt
director	giám đốc
satisfied	cảm thấy hài lòng, vừa ý, thoả mãn
tomorrow	Ngày mai
shareholder	cổ đông
ordinary	bình thường
youngster	thiếu niên
someday	một ngày nào đó
drink	uống
lung	phổi
operate	vận hành
verdict	bản án
exclusively	duy nhất
doctrine	học thuyết
hello	xin chào
begin	bắt đầu
unknown know	không biết, không được nhận ra
judgement	sự xét xử
viewer	người xem
works	công trinh
alive	sống sót
proportion	tỉ lệ
boyfriend	bạn trai
crystal	pha lê
pursuit	theo đuổi
weekend	ngày cuối tuần
neighbour	hàng xóm
plate	đĩa
tournament	giải đấu
bankruptcy	phá sản
cycle	chu kỳ
thinking	Suy nghĩ
world	thế giới
inquiry	yêu cầu
astronomer	nhà thiên văn học
dissolve	giải thể
angle	góc
december	tháng mười hai, tháng chạp
hopefully	hy vọng
immigrant	di trú
tradition	truyền thống
everything	mọi điều
urgent	gấp, khẩn cấp
programme	chương trình
table	bàn
in case	nếu......
columnist	nhà bình luận viên
bread	bánh mỳ
pence	đồng xu
side	bên
counseling	tư vấn
due to	vì, do, tại, nhờ có
break	phá vỡ
change	thay đổi
restaurant	nhà hàng
willingness	sự sẵn lòng
indirectly	gián tiếp
cupboard	1 loại tủ có ngăn
comfort	thoải mái
joke	đùa
likewise	tương tự
century	thế kỷ
hide	ẩn giấu
punishment	hình phạt
traditionally	theo truyền thống
corporate	công ty
discovery	khám phá
instruction	chỉ dẫn
candle	nến
report	bài báo cáo
married	cưới nhau
pants (PL)	quần (PL)
auto	Tự động
sigh	thở dài
theirs	của chúng, của chúng nó, của họ
constant	không thay đổi
several	một số
sign	ký tên
cotton	bông
angel	Thiên thần
office	văn phòng
northern	Phương bắc
anger	Sự phẫn nộ
scramble	tranh giành
high	cao
son	Con trai
split	phân chia
ought to modal	phải, nên, hẳn là
unfair, unfairly fair	không đúng, không công bằng, gian lận
publication	xuất bản
different	khác nhau
directly	trực tiếp
kneel	quỳ xuống
officially	chính thức
level	cấp độ
stick out	đòi, đạt được cái gì
give sth out	chia, phân phối
Islamic	Hồi giáo
preserve	giữ gìn
establish	thành lập
permanently	cách thường xuyên, vĩnh cửu
relevant	liên quan, thích hợp
proclaim	tuyên bố
attached	gắn bó
bunch	bó
spy	gián điệp
birthday	sinh nhật
behind	phía sau
candy	Cục kẹo
recipe	công thức
drugstore	hiệu thuốc, cửa hàng dược phẩm
box	cái hộp
mental	tâm thần
tiring	sự mệt mỏi, sự mệt nhọc
bow	cây cung
decent	phong nha
boy	con trai
racial	chủng tộc
switch	công tắc điện
total	toàn bộ
niece	cháu gái
upstairs	tầng trên
in front	ở phía trước
politely	lễ phép, lịch sự
consumer	khách hàng
highly	cao
one-third	một phần ba
unfortunate	không may, rủi ro, bất hạnh
chance	cơ hội
economist	nhà kinh tế học
initiative	sáng kiến
nature	thiên nhiên
social	xã hội
wheel	bánh xe
T-shirt	Áo thun
illegally	trái luật, bất hợp pháp
interesting	hấp dẫn
cross	vượt qua
control	điều khiển
medication	thuốc men
Christianity	Cơ đốc giáo
coloured	mang màu sắc, có màu sắc
drill	máy khoan
clerk	nhân viên bán hàng
acknowledge	công nhận
lobby	sảnh đợi
earth	trái đất
pulse	xung
essentially	bản chất
all right	tốt, ổn, khỏe mạnh; được
stance	lập trường
closest	gần nhất
stumble	tình cờ gặp
dancing	khiêu vũ
elbow	khuỷu tay
specialty	chuyên môn
vary	thay đổi
threatening	sự đe dọa, sự hăm dọa
upper	phía trên
county	quận
paint	Sơn
episode	tập phim
respondent	người trả lời
fighting	trận đánh
behalf	thay mặt
somewhere	một vài nơi
injure	làm bị thương
objective	mục tiêu
scene	bối cảnh
dynamics	động lực học
scandal	vụ bê bối
geography	địa lý, khoa địa lý
horrible	kinh khủng
friend	người bạn
scent	hương thơm
strengthen	củng cố
injury	chấn thương
exhibit	triển lãm
mushroom	nấm
publishing	công việc, nghề xuất bản
alcohol	rượu
deny	phủ nhận
closely	chặt chẽ
pleasure	vui lòng
hurricane	bão
hike	đi lang thang
remaining	còn lại
accept	Chấp nhận
glory	vinh quang
morning	buổi sáng
horse	con ngựa
secondary	thứ hai
mission	sứ mệnh
underwater	ở dưới mặt nước, dưới mặt nước
autumn	mùa thu
motor	động cơ
sue	kiện
access	truy cập
cooperate	hợp tác
overcome	vượt qua
sum	tổng hợp
unusually	cực kỳ, khác thường
neighboring	lân cận
sun	mặt trời
extended	mở rộng
serving	phục vụ
current	hiện hành
secretary	Thư ký
actively	tích cực
civilian	dân thường
key	Chìa khóa
surprised	ngạc nhiên
offensive	phản cảm
silk	lụa
silent	im lặng
storm	bão táp
manager	giám đốc
cartoon	hoạt hình
texture	kết cấu
maker	nhà sản xuất
amid	giữa
launch	phóng
store	cửa hàng
confirm	xác nhận
hill	đồi núi
bug	lỗi
gallon	galông 1gl = 4, 54 lít ở anh, 3, 78 lít ở mỹ
tightly	chặt chẽ
appoint	bổ nhiệm
mortality	tử vong
fourth	thứ tư
vast	rộng lớn
story	câu chuyện
but	nhưng
bus	xe buýt
sincerely	một cách chân thành
symbol	ký hiệu
declare	khai
sexuality	tình dục
dislike	sự không ưa, không thích, sự ghét
buy	mua
revelation	sự mặc khải
available	có sẵn
express	bày tỏ
advocate	biện hộ
confine	giam giữ, hạn chế
quest	nhiệm vụ
frequency	tần số
instantly	ngay lập tức
luggage	hành lý
missile	tên lửa
dynamic	năng động
written	bằng văn bản
generate	tạo ra
passion	niềm đam mê
sector	ngành
unusual	bất thường
extreme	cực
tuck	tuck
coordinate	danh từ
athlete	lực sĩ
sink	bồn rửa
degree	trình độ
ranch	trang trại
tube	ống
especially	đặc biệt
ocean	đại dương
naval	hải quân
once	Một lần
carpet	thảm
desk	bàn
hint	dấu
sing	hát
demonstrate	chứng minh
dishonestly	bất lương, không lương thiện
wheelchair	xe lăn
hire	thuê mướn
idea	ý kiến
kid	đứa trẻ
monument	tượng đài
inventory	hàng tồn kho
kit	bộ dụng cụ
missing	mất tích
throughout	khắp
virtue	Đức hạnh
successful	thành công
coverage	phủ sóng
lovely	đáng yêu
normal	bình thường
British	người Anh
brutal	tàn bạo
figure	nhân vật
gradual	dần dần, từng bước một
transmit	chuyển giao
consumption	tiêu dùng
technology	Công nghệ
weaken	làm suy yếu
stone	Cục đá
vaccine	vắc-xin
refer to	xem, tham khảo; ám chỉ, nhắc đến
migration	di cư
specially	đặc biệt, riêng biệt
passing	đi qua
gentleman	quý ông
advertise	báo cho biết, báo cho biết trước
compromise	thỏa hiệp
sack	bao
reach	chạm tới
lightly	nhẹ nhàng
react	phản ứng
feedback	Phản hồi
road	đường
justify	biện hộ
review	ôn tập
sight	thị giác
weather	thời tiết
tighten	thắt chặt
timber	gỗ
nobody	không ai
traveller	người đi, lữ khách
between	giữa
guide	hướng dẫn
longtime	thời gian dài
efficiency	hiệu quả
ethnic	dân tộc
collar	cổ áo
goal	mục tiêu
natural	tự nhiên
rightly	đúng, phải, có lý
go down	đi xuống
goat	con dê
banker	chủ ngân hàng
ironically	trớ trêu thay
intact	nguyên vẹn
following	tiếp theo
sensitivity	nhạy cảm
substantially	đáng kể
scared	sợ hãi
unwillingly	không sẵn lòng, miễn cưỡng
flag	cờ
racing	cuộc đua
sympathetic	đồng cảm, đáng mến, dễ thương
unsuccessful	không thành công, thất bại
wear	mặc
range	phạm vi
derive	lấy được
weak	Yếu
rock	đá
impress	gây ấn tượng
feature	đặc tính
lean	nạc
assert	khẳng định
flat	bằng phẳng
recall	hồi tưởng
leap	nhảy vọt
place	địa điểm
regular	đều đặn
objection	sự phản đối
dispute	tranh chấp
observation	quan sát
twisted	được xoắn, được cuộn
tired	mệt mỏi
aggression	Hiếu chiến
suggest	đề nghị
upside down	lộn ngược
leaf	lá
lead	chì
fraction	phân số
filter	lọc
expect	chờ đợi
site	địa điểm
sunlight	ánh sáng mặt trời
cease	ngưng
emotion	cảm xúc
assess	đánh giá
prescription	đơn thuốc
Chinese	Trung Quốc
apology	xin lỗi
argument	tranh luận
passage	đoạn văn
adequate	đầy đủ
linhpham	linhcutene
dozen	tá
tremendous	to lớn
growing	phát triển
plain	trơn
surprisingly	thật ngạc nhiên
only	chỉ có
should	Nên
justice	Sự công bằng
tag	nhãn
in common	sự chung, của chung
notebook	sổ tay
tap	gõ
indirect	gián tiếp
individual	cá nhân
salmon	cá hồi
ugly	xấu xí
tax	Thuế
towards	về hướng
excitement	sự phấn khích
person	người
testimony	lời khai
safe	an toàn
enforce	thi hành
departure	khởi hành
fragile	mong manh
presidential	tổng thống
herself	cô ấy
potentially	có khả năng
supposedly	được cho là
covering	sự bao bọc, sự che phủ, cái bao, bọc
week	tuần
sail	cánh buồm
cab	taxi
distinct	khác biệt
flee	chạy trốn
tune	điều chỉnh
aware	ý thức
can	có thể
drama	kịch
hair	tóc
award	giải thưởng
cap	mũ lưỡi trai
car	xe hơi
eligible	hội đủ điều kiện
marriage	kết hôn
ready	sẳn sàng
cat	con mèo
stove	bếp
alarm	báo thức
exempli gratia	trứng
weed	cỏ dại
village	làng
by means of	bằng phương tiện
privately	tư nhân
greatest	vĩ đại nhất
player	người chơi
smooth	trơn tru
unconscious	bất tỉnh, không có ý thức, không biết rõ
balloon	quả bóng bay
orientation	sự định hướng
racism	chủ nghĩa phân biệt chủng tộc
motion	chuyển động
good, well	tốt, khỏe
limited	giới hạn
satisfy	làm vui lòng
undo do	tháo, gỡ, xóa, hủy bỏ
february	tháng 2
match	trận đấu
fault	lỗi
accent	giọng điệu
clothes	quần áo
really	có thật không
lorry	xe tải
carrier	vận chuyển
fragment	miếng
response	phản ứng
independently	độc lập
category	thể loại
informal	không chính thức
rival	đối thủ
